Prefiro a vers√£o antiga que dava pra mandar msg pra outras pessoas de gra√ßa s√≥ com o wi-fi e a outra pessoa podia responder f√°cil sem Net e torpedo agora essa nova vers√£o t√° uma bosta pra isso existe o WhatsApp que da√≠ as 2 pessoas tem que ter internet tou desinstalando 	 n_util 
Precisa melhorar frente aos concorrentes. √â essencial ter a op√ß√£o de "cita√ß√£o", como no Whatsapp. Seria legal esclarecer mais sobre a privacidade das mensagens. E um recurso legal do Telegram para ser implementado √© o recurso de mensagens n√£o lidas. O Google parece que lan√ßou o Allo ainda em bet‚Ä¶ resenha completa 	 n_util 
The only problem why Brazilians will not change WhatsApp for Allo is due to the fact Brazilian mobile companies have an agreement that you don't use your data pack when using WhatsApp or Facebook, but I believe Allo is infinitely better! 	 n_util 
N√£o uso muito por ser de certa forma desconhecido entre meus amigos ainda, mas √© um dos melhores aplicativos de mensagens instant√¢neas, o bom √© que d√° pra mandar mensagem mesmo sem teu contato ter o aplicativo, simplesmente tendo Android j√° rola, muito bom. 	 n_util 
O app √© √≥timo mas est√° com um bug horr√≠vel de enviar fotos instant√¢neas direto pelo app... Apresenta falha na hora de tirar uma foto direto no chat pra enviar, o app fecha e √© reiniciado. Pra contornar isso, tem que tirar uma foto pela c√¢mera do celular e ent√£o enviar pela galeria, de outro modo n√£o‚Ä¶ resenha completa 	 n_util 
Gostei muito do aplicativo baixei hj estava com receio de baixar pois vi alguns coment√°rios falando que era preciso a outra pessoa ter o aplicativo pra poder ter o envio de msg, mais n√£o √© verdade o aplicativo possui as duas op√ß√µes independente da outra pessoa ter ou na o aplicativo tem como env‚Ä¶ resenha completa 	 n_util 
√â muito legal a gente pode definir um tema pra cada conversa E d√° pra conversar mesmo que n√£o tenha ningu√©m on line Por causa do Google assistente Mas o assistente pesquisa muito se puder corrigir isso eu agrade√ßo Ahh podia ter como ela guardar informa√ß√µes pessoais de forma segura claro 	 n_util 
O app √© muito bom no geral. Tive problemas com a inefici√™ncia das notifica√ß√µes, que nem sempre aparecem quando h√° novas mensagens... Meus amigos passaram pelo mesmo problema. Sinto falta do status de online ou offline, o app poderia incluir isso, assim como a op√ß√£o de visto por √∫ltimo 	 n_util 
Acho ele muito bom! A quest√£o √© que no Brasil, todas as operadoras n√£o descontam do pacote de dados os dados usados no WhatsApp, mas integrar a funcionalidade de pesquisa do Google durante a conversa √© muito boa. Pena que quase ningu√©m usa, mas da√≠ n√£o √© culpa do Allo. Queria tamb√©m pode fazer m‚Ä¶ resenha completa 	 n_util 
Muito r√°pido, as mensagens s√£o realmente instant√¢neas mesmo com sinal fraco de 4G e o assistente √© muito √∫til. O √∫nico problema √© que o celular tem que ficar conectado. Na minha opini√£o um retrocesso em rela√ß√£o ao hangouts que √© vinculado a conta do Google e funciona em qualquer navegador. 	 n_util 
Me divirto com esse app! Consigo realizar tarefas simples e dif√≠ceis como fazer liga√ß√£o, ativar alarmes e traduzir textos. Fora que quando algu√©m n√£o me responde no whats eu converso com ele kkkkkkkkk 	 n_util 
Configurado em ingl√™s, o assistente √© extremamente competente, mas em portugu√™s fica bem burro (ele diz que j√° aprendeu a nossa l√≠ngua). Tem que melhorar muito pra ter utilidade. Como comunicador, falta disponibilizar mais emojis e principalmente ajudar a distinguir, da lista de contatos, quem t‚Ä¶ resenha completa 	 n_util 
Estou adorando esse aplicativo. Muito f√°cil de usar. Melhor que outros apps cheios de v√≠rus e interrup√ß√µes. Podiam colocar junto a chamada de v√≠deo. Mas enquanto isso uso o Duo. N√£o tenham d√∫vidas, podem baixar, voc√™s v√£o gostar. 	 n_util 
A google poderia integrar os v√°rios conceitos numa s√≥ aplica√ß√£o. Hangouts, Allo e Duo juntos seria aquela super-aplica√ß√£o que n√£o daria hip√≥teses √† concorr√™ncia. Mesmo assim, e apesar da fraca ades√£o do p√∫blico, n√£o desilude. 	 n_util 
Perdeu a √∫nica funcionalidade que o destacava de outros mensageiros, que era enviar mensagens via wi-fi/dados m√≥veis para pessoas que n√£o tinham acesso √† internet. Essas, por sua vez, recebiam via SMS e podiam responde-las, ampliando as op√ß√µes de comunica√ß√£o. N√£o faz mais sentido ter ele instalado, ‚Ä¶ resenha completa 	 n_util 
Ent√£o assim q instalei apareceram 2 op√ß√µes uma pra criar o meu proprio avatar e uma outra q n me lembro... cliquei nas op√ß√µes mas n conclui a a√ß√£o e sai das op√ß√µes... procurei as op√ß√µes novamente e simplemente sumiram do aplicativo e n achei nehuma op√ß√£o ou bot√£o que me levassem a elas..... 	 n_util 
Adorei! Com certeza eu substituiria o WhatsApp por esse aplicativo, mas infelizmente eu n√£o tenho tantos contatos por aqui, e os que tenho na conta google; esse aplicativo n√£o importa, sendo necess√°rio que meus contatos fa√ßam uso do Allo tamb√©m. üòí 	 n_util 
As falhas na c√¢mera s√£o constantes, j√° enviei v√°rios feedback, mais nada resolvido at√© agora, tenho que tirar a foto da c√¢mera e depois compartilhar na maioria dos vezes, mesmo assim pra mim √© o melhor muitos recursos inovadores. 	 n_util 
Atualiza√ß√£o 5 de junho Essa √∫ltima atualiza√ß√£o ficou perfeito, est√° mais f√°cil enviar gifs, os meus est√£o mais organizados, o campo de mensagem ficou muito legal arredondado e com as op√ß√µes acima dela.. Est√° melhorando muito. Antigo. A proposta do app √© muuuuuuito boa, tem alguns erros mas porq‚Ä¶ resenha completa 	 n_util 
Sem d√∫vida um dos melhores apps de mensagens. Tem √≥timos recursos mas falta algumas coisas pr√°ticas que h√° na concorr√™ncia. Uma pena que seja mais um app Google a cair no esquecimento pq o p√∫blico n√£o usa. 	 n_util 
Ao desenvolvedor do aplicativo : O aplicativo est√° com problemas no envio de SMS, no aparelho que tem o aplicativo mostra que a mensagem foi enviada, por√©m n√£o recebe no n√∫mero de destino. Por favor, verifique esse erro e esclare√ßa na descri√ß√£o do aplicativo uma dimens√£o maior dele. Desde j√° agrade√ß‚Ä¶ resenha completa 	 n_util 
Excelente app... Gosto de todas as funcionalidades do Allo. √â o melhor app de mensagens do mercado. O WhatsApp n√£o chega perto, apenas tem mais usu√°rios porque as pessoas s√£o resistentes a mudan√ßas e porque iniciou primeiro. 	 n_util 
Nn est√° enviando os emoji para pessoas pelo sms gr√°tis nn ta enviando os emoji do teclado nem do pr√≥prio app google allo comcertem isso permitam kii Ele possa enviar oa emoji para pessoas ki usar para flr com pessoas por smsm eh google allo 	 n_util 
Eu tentei de v√°rias formas fazer com que dasse certo eu colocar meu n√∫mero mas nenhum SMS chega, tenho certeza que n√£o sou a √∫nica que passou por tal problema ent√£o... N√£o gostei 	 n_util 
Antes dava pra enviar SMS pra quem n√£o tinha o app, e a pessoa recebia independente de estar conectado a internet. Esse era o grande diferencial. Agora n√£o, virou c√≥pia do Whatsapp. Vou desinstalar! üëé 	 n_util 
APP muito bom ele j√° mostra o √°udio recebido em texto caso a pessoa n√£o possa ouvir e tem uma assistente pessoal muito legal que faz tudo que vc pede em seu celular. Nota 10 	 n_util 
N√£o conseguimos ouvir os √°udios colocando o telefone no ouvido, ele p√°ra de reproduzir, diferente do Whatsapp, vc n√£o tem privacidade para ouvir as mensagens, achar o contato √© confuso, nunca sabemos se ele tem ou n√£o o Allo instalado, mais um app para a bagun√ßa do Google: Hangouts, Messenger, A‚Ä¶ resenha completa 	 n_util 
*OLHA EU ACHEI SUPER LEGAL! MAIS DA PRA VCS COLOCAREN PRA ELA FALA NO MICROFONE, ATUALIZAR PRA ESCOLHE A VOS DELA. QUANDO AGENTE ENTRA NO CELULAR A GENTE CHAMAR ASSISTENTE, E ELA FALA O L√Å O QUE POSO AJUDAR. PUFAVOR ATUALIZEN. O BETA A√ç VCS COLOCAM A ATUALIZA√á√ïES 	 n_util 
Gostei muito uma pena pois meus contatos n√£o tem essa conta do allo... Mais eu sempre indico para meus amigos e parentes falando que bom App para comunica√ß√£o entre outros serve at√© para trabaho 	 n_util 
Comprei um celular novo. O WhatsApp fez o backup das conversas direitinho. E o Allo? NADA! Oh... Vcs precisam, URGENTEMENTE, melhorar esses detalhes. Ele tem tudo para ser o melhor. 	 n_util 
Ainda falta indexa√ß√£o com o google INBOX! Posso ver e responder msgs pelo Android wear... Mas n√£o tem nenhum √≠cone do Allo instalado no mesmo? Muito confuso! 	 n_util 
App relativamente bom, dificuldades na notifica√ß√£o, s√≥ recebi notifica√ß√µes se eu tiver aberto previamente o app, e tamb√©m o led de notifica√ß√µes n√£o √© ativado quando chega msg. Lenovo k5 	 n_util 
O aplicativo deveria dispor novamente da op√ß√£o de enviar SMS para quem tamb√©m n√£o possui o aplicativo. Possu√≠a essa op√ß√£o mas voc√™s tiraram, por favor coloquem novamente que eu troco minha avalia√ß√£o! 	 n_util 
Se voltase a ser como antes q dava pra envia sms de gra√ßa pros outros era otimo mas agora nao ta com nada nao tem nem como competir com o whatsapp 	 n_util 
Esse app √© bom, s√≥ que eles deviam ter acrescentado falas melhores para a Google Allo, pq as veses a gente fala alguma coisa, e ela responde as falas sem sentido, e como a maioria das pessoas gostam desses tipos de coisas, eles tamb√©m deviam acrescentar para a Google Allo, que ela devia responder as‚Ä¶ resenha completa 	 n_util 
Ele estava √≥timo, m√°s agora voc√™s tiraram a fun√ß√£o de enviar SMS at√© pra quem n√£o tem o app instalado. E agora ? Como vou enviar uma mensagem importante 	 n_util 
Precisa bota pra poder enviar sms ate pra quem ja tem o allo por que fica ruim fala com quem tem se a pessoa n tiver internet.. Por favor coloquem a op√ß√£o de fala por SMS tamb√©m por favor 	 n_util 
Achei muito bom, s√≥ que ainda tenho d√∫vidas se ele √© gratuito pra quem envia a msg pelo app, e tamb√©m mandei msg pra uma pessoa e chegou no telefone de outra com n√∫mero q √± tem nada a v√™ com a que eu enviei por favor espero uma resposta... 	 n_util 
Eu penssava q enviava SMS normalmente mas so envia pra quem tem o App vou desinstalar Por favor botem como era antes pra converssa com pessoas que n√£o tem esse App 	 n_util 
√â uma boa op√ß√£o para sair dos apps convencionais que cansam por n√£o ter uma novidade que esse app tem ainda estao em constru√ß√£o mas esta √≥timo! E vc cria o seu proprio emoji ü§ó 	 n_util 
Muito bom, Melhor app de mensagens, com recursos incr√≠veis de adesivos e memes! tudo bem brasileiro, mas por favor! coloquem "responder mensagens em espec√≠fico" isso √© essencial!!! e arrumem o bug da foto direto do app! 	 n_util 
It used to be great, but now it is not showing the emoji flags. Instead, it only shows a white flag with a question mark. I use Android 7. 	 n_util 
N√£o consigo usar o app, coloquei o meu n√∫mero, verifiquei, verifiquei de novo, apaguei e coloquei novamente, depois verifiquei, desinstalei e instalei de novo, tentei por meu n√∫mero, mas, n√£o aparece nenhum aviso e nem chega um SMS. Resolvam esse problema, quero muito um Google Assistente. 	 n_util 
O app era √≥timo, mas vc retiraram o envio de SMS gr√°tis pra quem n√£o possu√≠a o app instalado, desinstalando por causa dessa sacanagem, esse app vai descontinuado como Hangouts, √© bom, mas a falta de usu√°rios √© o que o torno p√©ssimo 	 n_util 
Seria bom mandar mensagens pra aquelas pessoas que num tem o Google allo a√≠ sim esse app seria muito melhor a √© s√≥ num retira a fun√ß√£o de mandar mensagens pelo wi-fi 	 n_util 
O Allo n√£o identifica contatos novos salvos. Simplesmente aparece como se a pessoa n√£o possu√≠sse o App instalado, mesmo j√° estando conversando comigo. 	 n_util 
App muito bom e layout muito bonito. S√≥ falta usu√°rios nele. Quase n√£o tem contatos ativos usando o app. Voc√™s deveriam integrar ele s√≥ sistema e abolir o "Hangouts" e "mensagem " 	 n_util 
Poxa o allo enviar mensagem normal sem a outra pessoa ter o aplicativo agora ta ruim porque tem qui convidar as pessoas para usa 	 n_util 
Eu falava com a minha namorada. . Mais agora o apk nao envia mais mensagem so se a outra pessoa tiver O apk. . . Assim ele se torna in√∫til 	 n_util 
Essa mensagem gratis fica em alguma aba exclusiva? Quando eu mando so fica um tique e nao 2 .a pessoa que n√£o usa o app recebe as mensagens? Dei uma estrela e se ningu√©m me auxiliar eu vou desinstalar 	 n_util 
O aplicativo estava √≥timo, mas agora toda vez que abre a camera o Allo fecha, os gifs as vezes bugam e ele ultimamente tem gravado audio sozinho, sem apertar no bot√£o. Corrijam isso !!!!!!! 	 util 
Pessoal o app ainda tem como enviar mensagens para quem n√£o tem o app instalado, s√≥ que est√° melhor que antes pois n√£o chega como SMS e sim como um popup do allo, mesmo a pessoa n√£o tendo instalado. E ela pode responder mesmo sem Internet e SMS. Aproveitem! 	 util 
S√≥ usava este app para trocar msg com quem n√£o tinha internet , atualizaram e tiraram essa op√ß√£o, desinstalando pois agora nem tem utilidade nenhuma , Arrumem isso 	 n_util 
Eu vou em ti eu vou te falar a entrada como entrar voc√™ j√° tem sua conta n√© voc√™ coloca o 11 depois coloca o n√∫mero de telefone depois do 11 11 a√≠ o seu n√∫mero de telefone t√° s√≥ 11 colocar 11 depois coloca o seu nome n√∫mero quer dizer 	 n_util 
√â √≥timo, funciona muito bem. Falta coisas para se equiparar com os concorrentes mas o que j√° foi entregue est√° excelente. Ali√°s, a fun√ß√£o de transcrever a fala √© maravilhosa. 	 n_util 
Minha irm√£ tem ela disse que abaixasse gente voc√™ n√£o vai se arrepender. Tem v√°rias pessoas a siri e tem a que eu vou ficar esqueci o nome. 	 util 
Esse app e muito bem feito tem um design lindo e bem divertido, por√©m √© pouco conhecido. Me adicione no Allo a gente pode conversar. üòâ 	 n_util 
Esse app √© muito melhor que o WhatsApp. porque tem como fazer o seus pr√≥prios emojis (do seu rosto), tem como gravar aldios, tem a Google assistente, nele vem seu pr√≥prio plano de fundo, emojis interessantes e √© muito mais fofinho 	 n_util 
Muito bom, principalmente a assistente, ela me ajuda demais e quando estou entendiado, eu fico jogando pelo app, muito bom, sem palavras! √â perfeito! 	 n_util 
Eu sai do WhatsApp pra usar o Allo, e essa tarde 15/09 o aplicativo simplesmente parou de funcionar. √â lament√°vel! 	 n_util 
Aplicativo muito bom! Por√©m, ainda h√° melhorias para serem feitas. Para v√≠deo chamadas √© necess√°rio baixar outro aplicativo do Google. 	 n_util 
Ja desinstalei o WhatsApp, estou usando apenas este e tem sido de grande utilidade, acredito que viram melhoras a cada nova atualiza√ß√£o. 	 n_util 
App muito bom porque n√£o tem aqueles an√∫ncios chatos como do Watzap ate descobrirem que uma grande maioria de usu√°rios esta optando por ele no momento. 	 util 
Esse APP era O melhor, agora n√£o passa de um Simples app Coloquem a Fun√ß√£o de Enviar SMS de Novo MDS desse jeito. vcs v√£o acaba estragando o app mais do que ja ta ajeitem isso pela mow coloque a Fun√ß√£o SMS de novo üòëüòëFa√ßa o Favor de responder meu coment√°rio por que e gra√ßas a nois que o app tem ‚Ä¶ resenha completa 	 n_util 
Eu estou com um problema que eu boto meu n√∫mero por√©m ele s√≥ fica carregando e n√£o manda SMS para confirmar 	 n_util 
Aplicativo muito bom e divertido, por√©m ainda faltam algumas funcionalidades importantes como responder a uma mensagem anterior com quotes. 	 n_util 
N√£o instalo este app nunca mais. Voc√™s tiraram aquela fun√ß√£o de enviar mensagem para quem n√£o tivesse o app. :/ Espero que adicionem de volta o servi√ßo. Gabriel agradece a compreens√£o. 	 util 
Por que tiraram a op√ß√£o de mandar sms de gra√ßa sem a outra pessoa precisar de internet? ODIEI! Era, E R A √≥timo, agora √© in√∫til. 	 util 
Era o melhor, superava o Whatsapp em recursos. Uma pena que o Google ao inv√©s de divulga-lo resolveu descontinua-lo. 	 n_util 
N√£o vi mais a fun√ß√£o SMS gr√°tis t√¥ saindo fora kk quando voltar eu volto com nota maxima 	 n_util 
Era o melhor agora vcs tiraram a melhor fun√ß√£o dele de mandar sms gratuito ajudava bastante voltem por favor 	 n_util 
Aplicativo muito bom, por√©m poderia melhor, colocar o visto por ultimo da pessoa, ou se ela esta online, algo do tipo... 	 util 
Muito bom, mas precisamos nos certificar da privacidade de informa√ß√µes conversadas. Por isso pe√ßo que a Google nos d√™ uma posi√ß√£o sobre isso. 	 util 
Muito bom! Bem melhor que o whatsapp em termos de funcionalidades e em termos de qualidade! E ainda tem integra√ß√£o com o Google Duo! 	 n_util 
N√£o consigo mais enviar SMS gr√°tis para quem n√£o possui o app. Poderiam colocar esta op√ß√£o novamente. 	 util 
t√° horr√≠vel baixo ele n√£o consigo desinstalar e fica reiniciando meu celular a cada 5 minutos, pensei at√© que era meu celular mas a√≠ foi s√≥ formatar e n√£o reinicia mas a√≠ baixei denovo e aconteceu a mesma coisa 	 util 
bom de mais o melhor msm e q pode mandar menssagem sem a outra pessoa tiver net e ela aiinds pode te manda de volta sem net e sem torpedo soh q demora um pouco pra chegar deve ser a operadara dos chip q demoram receber msm üòé 	 util 
A Google √© mttt engra√ßada kkkkkkkkkk eu converso com ela mais do q eu esperava... Otimo app 	 n_util 
A Google deveria dar mais aten√ß√£o √†s opini√£o das usu√°rios, quem sabe esse seja o ponto fraco da Google. De fato seria muito melhor se de alguma forma desse mudar o nome do assistente. 	 util 
O app √© √≥timo, s√≥ precisa de mais fun√ß√µes que existem no concorrentes, e melhorar ainda mais as fun√ß√µes exclusivas dele. Se houver investimento tem chances de virar uma grande op√ß√£o, ainda mais depois dos problemas de seguran√ßa enfrentados pelo Facebook, e as ideias de inserir an√∫ncios no whatsapp. ‚Ä¶ resenha completa 	 util 
O aplicativo √© muito bom! Mas o √∫nico problema √© que, quando mandamos ou recebemos GIFS, ele salva no dispositivo e a galeria do celular acaba ficando cheio de Gifs, deveria ter a op√ß√£o de desejar salvar no dispositivo ou n√£o. 	 util 
Goste d+, o bom q realmente ele envia msg via SMS para outra pessoa, e o melhor √© que a pessoa q recebeu a msg , ela pode responder tb via SMS sem ter cr√©dito ou estar conectado na net üëç 	 util 
Ele √© √≥timo mais poderia dar pra botar status como o watzzap. E fazer chamadas de v√≠deo sem precisar do Googledu 	 util 
Muitos ainda est√£o na popularidade do WhatsApp por√©m o Google Allo tem Intelig√™ncia Artificial que nos auxilia a todo momento nas pesquisas dentro do Allo, e o mais legal √© enviar SMS de gra√ßa pra qualquer celular mesmo que n√£o tenha o G-Allo! Recomendo instalar al√©m de ser super leve! 	 util 
Esse App e bom, mas pode melhorar muito ele podia ter a fun√ß√£o de colocar o status e ele est√° travando muito, n√£o consigo tirar fotos com ele para enviar pq ele trava e sai da c√¢mera, fora isso e bom. 	 util 
Muito Bom gostei bastante tem mais fun√ß√µes que o concorrente (W), ele √© mais r√°pido para enviar e receber √°udio, imagem, muito f√°cil fazer pesquisas, nem precisa sair do aplicativo para faser pesquisas, entre outras . Bom App de mensagem 	 util 
Por que ao inv√©s de voc√™s ficarem criando um monte de apps de mensagens confusos, n√£o juntam tudo isso numa plataforma s√≥. Que tal fundir esse allo, duo e hangouts numa plataforma √∫nica? Fica a dica! ;üòâ 	 util 
Ele E MT Bom Porem Esses Dias Ele Tem Apresentados Problemas, Algumas MSG Nn Est√£o Chegando Para O Destino E Algumas Nn Recebo, Se Resolvessem Me Ajudaria Muito 	 util 
Apaguei o Whatsapp e quem quiser falar comigo use o Allo! precisa de ajustes, mas amei o App! Free SMS And Google assistant embeded. (automatic voice message transcription) 	 util 
Baixei o Google Allo hoje; mas, n√£o consigo entrar. Pus meu n√∫mero, e um c√≥digo de confirma√ß√£o foi pedido. Mas at√© agora o c√≥digo n√£o chegou. Tentei a op√ß√£o "ligue para mim", mas tamb√©m n√£o funciona; diz que n√£o √© poss√≠vel conectar aos servidores do Allo. Gostaria muito uma explica√ß√£o para isto. 	 util 
Muito bom,com o Google assist√™ncia meu dia dia ficou 100 vezes melhor,muito obrigado pelo apk.otimo trabalho. 	 util 
App do Google maravilhosoooo!!! Estou usando j√° faz um certo tempo e estou amando!!! Oferece principalmente toda a privacidade que n√£o existe no Whatsapp para conversar e ainda possui diversos outros recursos incr√≠veis!! At√© desinstalei o Whatsapp pois achei esse App muito melhor, sem d√∫vidas!! Pode‚Ä¶ resenha completa 	 util 
Otimo app melhor q o WhatsApp, mas ele precisa muito evoluir, precisa da sele√ß√£o de mensagem pra resposta e tem q aparecer se a pessoa esta online ou n√£o. 	 util 
O Allo √© um √≥timo mensageiro, mas infelizmente o Google interrompeu deu desenvolvimento. 	 n_util 
Antes dava pra enviar msg para quem n√£o tinha internet ou wi-fi agora n√£o da mais .. melhor fica com o WhatsApp MSM. Sinto MT em ter q desinstalar 	 util 
Olha s√≥ n dei 5 pq a minha google n ta falando por voz, s√≥ por texto. J√° tentei alterar mais n achei a fun√ß√£o. Alguem pode me dar uma dica? 	 util 
E bom s√≥ q n√£o tenho muito gente q usa esse App e poucos contatos. 	 util 
Ele n√£o entrega algumas msg e tamb√©m ocorre atraso na chegada de mensagens, te mensagem antiga que chega 1 dia depois! Arrumem isso por favor 	 util 
Eu amei principalmente pelo Google assistente,mas pode ter uma melhora e a melhora do Google Assistant realizar comandos por voc√™ tipo "mensagem de Oi para tal pessoa " isso realizar comandos e quem sabe voc√™s tamb√©m podem adicionar a Siri no Google Allo ficaria top voc√™s seriam N1 de certeza e baix‚Ä¶ resenha completa 	 util 
T√° um lixo....antes ele mandava SMS pra pessoas sem conex√£o e sem o app Agra ele t√° c√≥pia do WhatsApp..se for pra funcionar desse jeito n√£o adianta PK n√£o d√° pra brigar com o watsapp...desinstalando aqui...ningu√©m usa c√≥pia.. 	 util 
O Allo seria um excelente aplicativo se a Pesquisa funcionasse. Sua pesquisa √© in√∫til, pois s√≥ funciona para os nomes dos contatos do Allo e nunca funciona para o m√≠nimo: textos das mensagens... 	 util 
O search n√£o funciona de jeito nenhum em nenhum aparelho meu. E devia ter uma fun√ß√£o igual a do MSN de chamar a aten√ß√£o, bjkas te amo Google 	 util 
Parte do Google Assistente fica hora em ingl√™s hora em portugu√™s, como nas notifica√ß√µes de clima e tr√¢nsito. 	 n_util 
o aplicativo √© excelente, porem ainda incluir varias coisas tais como, o usu√°rio poder responder uma conversa no chats de um amigo, tanto em PV quanto em chats de grupos, poder editar msg enviadas, poder add seu pr√≥prio wallpaper/temas etc... Por enquanto dei 2 estrelas quando atualiza por favor add‚Ä¶ resenha completa 	 util 
Antes era bom, mais agora tiraram o diferencial que √© os SMS gr√°tis para os contatos, mesmo que n√£o tivessem internet. Agora o APP n√£o tem diferenciais que sejam de fato bons. 	 util 
Simplesmente n√£o consigo fazer activa√ß√£o. Pede para incerir o n√∫mero telem√≥vel para receber SMS com c√≥digo de confirma√ß√£o e nada. Nenhuma SMS durante todo dia. J√° repeti milhares de vezes e nada 	 util 
O app √© bom, so deveria ter o visto por ultimo e quando a pessoa ta online neh, arrumem isso depois volto dar 5 estrelas se colocarem isso do visto 	 util 
Ele apresenta alguns problemas como a assistente n√£o ativar pelo comando de voz. E isso complica muito a utiliza√ß√£o. Mas nas outras coisas, como as assinaturas funciona perfeita mente. 	 util 
Informa√ß√£o Galera ! Antes dava para responder gratuitamente os sms. Agora infelizmente a quem responde , est√° sendo cobrado. ! 	 util 
√â muito bom pois da at√© para conversar com quem n√£o tem o APP e a outra pessoa n√£o precisa ter internet s√≥ tendo √© o suficiente amei s√≥ n√£o dou mais estrelas pq n√£o tem como 	 util 
Ele n√£o abre os jogos que abria antes!Eu s√≥ falava "vamos jogar" e ele abria v√°rios jogos do google r agora ele diz que n√£o tem certeza!!ME AJUDE GOOGLE 	 util 
Pra mim ele veio como "salva√ß√£o"pois tenho muitos contatos que n√£o tem acesso a internet e como eu uso muito a internet como wi-fi e j√° estava cansada de usar meus cr√©ditos de dados de redes....,o melhor que meus contatos n√£o precisa est√° conectado a internet para receber meus sms... esse app pra mi‚Ä¶ resenha completa 	 util 
√â bom, oferece uma interface limpa √© completo no quesito informa√ß√£o, e tem gifs, memes e adesivos interessantes e a google assistente atende muito bem o que eu pe√ßo 	 util 
O aplicativo em si √© bom, mas tem um problema que vem me afetando, um amigo meu tem esse mesmo App, s√≥ que no meu allo, parece como se ele n√£o tivesse, como fa√ßo para falar com ele?? 	 util 
Gostaria de saber se a Google abandonou o app. √öltima atualiza√ß√£o foi em janeiro/2018. Desde ent√£o, nenhuma novidade foi adicionada a ele. Tinha tudo pra ser um app de grande porte a usu√°rios. 	 util 
Ele n√£o reconhece os meus contatos. Esse app foi lan√ßado em 2016. J√° faz dois anos e ainda n√£o corrigiram esse bug insuport√°vel. Qual √© Google? 	 util 
Mto bom... algu√©m sabe de um app com a mesma tecnologia do A.I do goolle allo..porem para todos os apps de mensagens de textos instant√¢neas e redes sociais ?..tipo um app que aprenda com voc√™ e lhe d√™ sugest√µes de palavras.. textos.. d√∫vidas.. emojis e at√© gif?. ficando sob os apps como um pop-up..s‚Ä¶ resenha completa 	 util 
√â melhor que o zap pena que ningu√©m usa, muito r√°pido e eficiente e os recussos s√£o top. Voc√™s t√£o de parab√©ns 	 util 
Uma pena tirarem a SMS de gra√ßa para quem n√£o est√° no app, agora s√≥ da pra Convidar as pessoas que n√£o est√£o no app e conversa pra quem est√° no app 	 util 
Esse aplicativo √© p√©ssimo porque n√£o v√™ se t√° online e nem o visto por √∫ltimo Ent√£o ele deve melhorar bastante tinha que ter status melhor Resumindo ele √© p√©ssimo üôÑüò∂ 	 util 
ANTES ERA MUITO BOM DAVA ATE PRA TROCAR SMS OFFLINE SE EU TIVESSE COM INTERNET PODERIA ENVIAR MENSAGEM SMS PRA OUTRA PESSOA QUE NAO ESTIVESSE COM INTERNET QUE ESSA PESSOA TANTO RECEBERIA A MENSAGEM QUANTO PODERIA RESPONDE ELA E CHEGAVA NO MEU CELULAR DE BOA. HOJE ATE COM INTERNET NOS DOIS APARELHOS ‚Ä¶ resenha completa 	 util 
O app √© muito bom,se voc√™ n√£o tem muitos amigos(4amigos)como eu ele √© perfeito e engra√ßado baixem ele √© √≥timo üòô 	 util 
Mano.. amei . J√° acho melhor que WhatsApp... Meu s√©rio.. Esse app √© lindo, e muito funcional.. Por favor n√£o criem, status.... N√£o sei se tem como criar grupos, n√£o tentei ainda. Mas n√£o gosto de grupos E se for colocar grupos, fa√ßam que sejam tempor√°rio.... ‚ù§Ô∏è‚ù§Ô∏è‚ù§Ô∏è‚ù§Ô∏è‚ù§Ô∏è 	 util 
Eu adoro as Gifs da Google Allo eu acho mto melhor que do WhatsApp, mais din√¢mico e divertido, f√°cil para mandar pesquisar e bem din√¢mico eu sempre √çndico 	 util 
He encontrado la aplicaci√≥n muy buena pero como nadie de mi familia utiliza entonces no uso mucho m√°s s√≠ es muy bueno. 	 util 
Gostei muito do aplicativo, principalmente porque podemos enviar mensagem para quem n√£o tem Internet, s√≥ falta mostrar quando se est√° online ou n√£o. 	 util 
Melhor app de mensagens que j√° usei na vida! Divertido, pr√°tico, funcional, engra√ßado e inteligente! 	 n_util 
Mano, esse App √© top. A jun√ß√£o com o Duo, as v√≠deos chamadas s√£o super est√°veis! 	 util 
O App √© muito bom ; s√≥ acho que a assistente deveria comunicar por √°udio tamb√©m , porque ela so fala via mensagem . üò≠üò≠ 	 util 
Melhor App de comunica√ß√£o, mil vezes melhor que o whatsapp, n√£o sei pq n√£o fazem propaganda dele, eu j√° estou recomendando pra todo mundo. 	 util 
Ah muito que se melhorar,seria bacana v√™ quando a pessoa est√° on-line e quando mudar o papel parede n√£o mudar o da pessoa e o da outra pessoa q est√° conversando tamb√©m... 	 util 
App top s√≥ falto poder fazer liga√ß√µes para pessoas q n√£o tem o app ,i as liga√ß√µes n√£o custaria nada s√≥ usaria a internet ia ficar top 	 util 
Um app muito bom e completo, s√≥ falta uma comunidade grande. Achei bem melhor que o WhatsApp, principalmente devido a integra√ß√£o com o Google assistant. 	 util 
Era bom, agora nem envia mais SMS se a outra pessoa n√£o tiver o App ou estiver On! N√£o √© mais √ötil! 	 util 
A pessoa que tbm tem o aplicativo instalado ,s√≥ recebe A msg se Tiver internet. Se for assim q utilidade tm? 	 util 
N√£o tem tantas op√ß√µes quanto os concorrentes, a A.I. n√£o est√° funcionando mais direito, quase ningu√©m utiliza. N√£o recomendo, melhor o Whatsapp ou Telegram. 	 util 
O Meu aplicativo n√£o vai! Quando eu coloco meu n√∫mero e aperto em "continuar" simplesmente n√£o vai! 	 util 
A Google √© uma √≥tima empresa para a cria√ß√£o de novos apps que melhoram e deixam as nossas fun√ß√µes b√°sicas e organizacionais mais f√°ceis e intuitivas no nosso dia a dia. Quanto a mensageiros e redes sociais, tem sido p√©ssima em evoluir e atrair mais pessoas para o uso delas. O Google Allo realmente t‚Ä¶ resenha completa 	 util 
Adorei esse aplicativo, um √≥timo recurso pra quem n√£o tem Whatsapp. Bem completo. 	 util 
Meu irm√£o tem o Google Allo, mas n√£o consigo achar ele, at√© mandei o link pra ele, mas ainda n√£o consigo achar ele. Observa√ß√£o: Ele est√° nos meus contatos. 	 util 
O App √© √≥timo, e n√£o fica entulhado m√≠dia na mem√≥ria do celular, como o WhatsApp. Mas o Google n√£o divulga esse neg√≥cio, ningu√©m usa, ningu√©m conhece. Uma pena... 	 util 
O app √© bom. √önico prblema √© que demora muito para o destinat√°rio receber as mensagens. Chega a ter um atraso de at√© 24hs, e n√£o √© por falta de interner do destinat√°rio. 	 util 
Eu amo os produtos Google. Mas o allo e o duo, que acredito muito no potencial, precisa de melhoras urgentes. Principalmente para sincronizar os contatos que est√£o salvos no aparelho. Se voc√™s querem vencer o WhatsApp, precisam melhor muito. Parece que voc√™s s√≥ querem lan√ßar apps e deixam pra l√°‚Ä¶ resenha completa 	 util 
√â um app divertido e interativo, por√©m deixa a desejar na precis√£o das notifica√ß√µes, e no desempenho (principalmente quando se quer pesquisar uma palavra em um chat) 	 util 
√â √≥timo, cheio de recursos legais, √© agora converte os aquivos de som em mensagem de texto. √ìtimo 	 util 
√â bom. Mas precisa de mais coisas novas. Al√©m de sempre oferecerem "Adesivos" novos, poderiam fazer mais temas tamb√©m para o chat de conversa. FA√áAM MAIS TEMAS !!! 	 util 
Gostei muito recomendo bom se todos os outros App fossem eficientes como esse. Parab√©ns 	 util 
Muito bom! S√≥ falta mais povo nela. Poucos dos meus amigos a usam‚òπ 	 util 
Pra ficar bom de novo atualizem pra que possa enviar sms da operadora normal, porque isso √© s√≥ uma imita√ß√£o barata do WhatsApp! 	 util 
Muito mais divertida que o WhatsApp... Mais GIF e memes. Vale a pena experimentar, pois s√≥ falta mesmo aumentar a comunidade! 	 util 
Muito bom, √© intuitivo e ainda t√™m como criar carinha personalizadas, al√©m de claro ser interligado ao Duo para chamadas de v√≠deo. Perfeito! 	 util 
O app deveria ter a op√ß√£o de enviar mensagens por SMS, mesmo pra quem tem o Allo instalado. No momento s√≥ envia SMS pra quem n√£o tem o Allo instalado. 	 util 
Para mensagens mais longas, n√£o √© poss√≠vel paragrafar. Sinto falta de outros recursos, como responder a uma mensagem espec√≠fica. No mais, me atende muito bem. 	 util 
N√£o d√° pra fazer nada porque tem q permiti tudo ou negar mas se negar tudo a√≠ q n√£o d√° pra fazer nada mesmo muito ruim 	 util 
Me adiciona. Falta pode ouvir os audio continuamente sem ter q aperta play assim como √© telegran. De todo e maravilhoso incompar√°vel. 	 util 
Esse allo √© um p√©ssimo aplicativo, gostaria de saber o fundamento!melhor usar o WhatsApp n√£o?? Lixo, n√£o instalem... S√≥ perdi meu tempo. 	 util 
Considero o Allo melhor app da categoria. Al√©m de possuir as mesmas funcionalidades, comuns em alguns apps concorrentes com servi√ßo semelhante, oferece nova experi√™ncia de uso e e integra√ß√£o com outros servi√ßos Google (como o Duo ou o Google Assistente, que tamb√©m s√£o excelentes), de acordo com ‚Ä¶ resenha completa 	 util 
Queria deixar aqui minha sugest√£o de que se o Google assistente falasse seria a melhor coisa do mundo!! Por favor fa√ßam isso na pr√≥xima atualiza√ß√£o!! 	 util 
As vezes as pessoas me mandam SMS mas as msgs Nn chegam, o app √© bom, s√≥ tem q concertar isso 	 util 
E muito bom , tenho que admitir que √© melhor que o WhatsApp, mais deveria ter mais temas de fundo, ser dessa para mudar s√©ria at√© mais legal. 	 util 
Esse app √© bem lg eu amei super recomendado principalmente o google assistente pra quem nao tem vai ter ele e muito lg super recomendado parabensüëçüëçüëç 	 util 
Aplicativo super divertido, cheio de fun√ß√µes muito legais, so faltou se popularizar e um pouco de marketing ai, valeria muito a pena investir ein...!! 	 util 
O app em si e bom, mas parou de receber atualiza√ß√µes. 	 n_util 
Gostei de tudo a √∫nica coisa que faltou foi ela falar √°udio ela n√£o fala √°udio ela s√≥ escreve texto Isso √© muito ruim eu sei de tudo a √∫nica coisa que faltou foi ela falar √°udio ela n√£o fala 	 util 
Tudo da Google √© muito, pena que muitas pessoas nao a conhe√ßam. Talvez um marketing ajudaria, vejo muito potencial alem de ser bem fluido. 	 util 
Vou ver se e bom pq a Google assestente N√£o pega na minha vers√£o do Android a vers√£o minha e 7.0 	 util 
Cad√™ as atualiza√ß√µes do app? Vamos aperfei√ßoar mais este app que pra mim e dos melhores. 	 util 
Acho melhor que Wpp e Messenger. S√≥ precisa melhorar a transcri√ß√£o dos √°udios e colocar a op√ß√£o que permite responder mensagens espec√≠ficas. O que mais me agrada √© n√£o exibir se estamos online, tampouco "visto por √∫ltimo", nem ter status. Espero que continue assim, diferenciado. H√° mais de um ano‚Ä¶ resenha completa 	 util 
Gostei porque eu consigo falar com meu namorado por aqui e bom demais est√£o de parab√©ns 	 util 
Tem adesivos tem√°ticos Star Wars, Stranger Things, possibilidade de criar adesivos com base em foto do usu√°rio e muito mais, al√©m de GIFs muito legais. 	 util 
Pqp t√° de brincadeira q essa desgra√ßa n acabou ainda velho al√©m de roubar os streamers de plataformas melhores com Twitch e tals ainda tenta ficar vivo com funcionalidade nem funciona pqp velho insta e MT melhor. 	 n_util 
A gente tentamos n√£o fala mal do facebook mas n√£o adianta. Al√©m da bagun√ßa nas notifica√ß√µes. Agora n√£o √© poss√≠vel carregar o portugu√™s. Parab√©ns Facebook parab√©ns mesmo viu para n√£o dizer ao contr√°rio 	 n_util 
O Facebook est√° melhorando a cada dia mais tem um probleminha tem um Android desconhecido na minha conta eu troco de senha mais mesmo assim ele continua voc√™s precisam mudar a seguran√ßa do Facebook 	 util 
Claro que sempre vir√° novas melhorias, por enquanto t√° √≥timo pro meu uso pessoal e profissional!! 	 n_util 
O Facebook N√£o entra na minha conta aparece sem internet mas tenho Internet .espero uma resposta sobre isso os criadores? 	 util 
Depois da actualiza√ß√£o o App est√° encerrando a todo momento em ambos celulares que eu tenho. 	 util 
N√£o Tenho o que ne aqueixar 	 util 
N√ÉO ENTENDO ESSE FACEBOOK, QUERENDO PROTEGER MINHA CONTA, E J√Å √â A D√âCIMA VEZ QUE T√Å QUERENDO TROCAR MINHA SENHA. J√Å N√ÉO TENHO MAIS IDEIA DE QUERO A SEJA COLOCAR 	 util 
O App √© o melhor app para rede social 	 n_util 
√ìtimo app gostei 	 n_util 
Um lixo 	 util 
Mantenho as amizades 	 util 
Otimo 	 n_util 
Bom 	 n_util 
Gente n√£o tem como melhorar o Facebook, se a gente que comenta algo na foto do amigo, n√£o est√° lendo, se escreve tamb√©m n√£o funciona 	 n_util 
N√£o arranca a aplica√ß√£o no in√≠cio. 	 n_util 
Bem utilit√°rio 	 n_util 
Porque que a barra no WhatsApp m√≥vel pra cima √© pra baixo, j√° Facebook √† barra branca trava n√£o move, v√™ se d√£o uma arrumada fala s√©rio üò± 	 n_util 
√öltima vers√£o n√£o tem defini√ß√µes da app como j√° d√° anterior a esta. E n√£o obtenho resposta 	 n_util 
Muito ruim... N√£o atualiza o feed, n√£o tem como adicionar amigos, arrume logo isso!! 	 n_util 
Ultimamente esse aplicativo pra mim nao ta prestando p nada. 	 n_util 
Muito bom 	 n_util 
Muito ruim eu posto uma foto a√≠ nenhum dos meus amigos recebe na time line T√° horr√≠vel n√£o consigo postar nada arrumem por que n√£o √© de hoje que ele t√° muito ruim , fica travando toda hora !!! Melhorar isso pq vcs s√£o capazes de muito mais !!!‚ò∫Ô∏è 	 n_util 
O aplicativo √© p√©ssimo, quando receber alguns v√≠deos comemorativos, ao tentar publicar aparece a mensagem, "Um problema impediu o carregamento do seu v√≠deo...", quando tenta publicar de novo, o v√≠deo simplesmente some. Isso significar, que o v√≠deo comemorativos n√£o tem utilidade nenhuma, pois n√£o h√°‚Ä¶ resenha completa 	 util 
S√≥ queria saber porque sumiu a op√ß√£o "ver como", era um dos recursos mais √∫teis em rela√ß√£o a privacidade do usu√°rio. O melhor jeito da gente ver como os nossos contatos e os que nao s√£o nossos contatos viam nosso perfil, por favor volteeeeem com isso 	 n_util 
N√£o sei o que est√° acontecendo mas quando eu entro no Facebook n√£o consigo atualizar as postagens da linha do tempo e tamb√©m n√£o consigo ver os coment√°rios fica carregando e n√£o abre (n√£o √© problema com a internet pois todas outras redes sociais est√° abrindo normal). Arrumem isso toda semana tem atu‚Ä¶ resenha completa 	 n_util 
Eu quero receber as notifica√ß√µes de push dos Grupos quando eles publicarem fotos e v√≠deos e aparece na tela do celular agora e no sininho agora mesmo junto com a bolha vermelha de n√∫mero e quero receber as notifica√ß√µes de push dos meus amigos do Facebook quando eles publicarem fotos ou quando eles p‚Ä¶ resenha completa 	 n_util 
Depois da √∫ltima atualiza√ß√£o os links de post n√£o abre (ex: algu√©m posta um link de uma loja nos coment√°rios, eu clico em cima do link mas n√£o redireciona para a p√°gina)! Espero que corrijam isso logo. 	 util 
Foto de perfil redonda que melhor era outro formato e vai abrir alguma p√°gina volta ao feed, para corrigir desinstalo e instalo novamente mais ap√≥s um tempo volta a mesma coisa uma atualiza√ß√£o n√£o seria nada mal. 	 n_util 
Ficaria melhor ainda se colocassem a op√ß√£o de "Marcar todas como lidas" porque √© chato ter que ficar abrindo as notifica√ß√µes que n√£o estamos t√£o interessados uma a uma. Eu tenho o app lite do Facebook tamb√©m instalado s√≥ porque ele tem essa op√ß√£o. 	 n_util 
Como √© que eu vou dar uma opini√£o se eu abro se eu pelejo para abrir meu Face desde cedo desde 8 horas da manh√£ at√© agora meu Face n√£o abre porque t√° configurando o portugu√™s n√£o sou obrigada a ficar sem ele n√£o s√≥ me d√° uma resposta por favor 	 n_util 
Ap√≥s atualiza√ß√£o (Lenovo Vibe K6) o app fecha sozinho, trava, pede sempre para confirmar aparelho quando faz login, sabendo que o aparelho j√° est√° salvo no sistema. As vezes o √°udio funciona com os v√≠deos e outras vezes n√£o. N√£o sei o que fizeram, mas ficou p√©ssimo utilizar esse app. 	 n_util 
Ao abrir os an√∫ncios de venda tanto nos bazares como publica√ß√µes particulares, aquelas sugest√µes de coment√°rios "valor" "quanto" etc est√£o atrapalhando muito!!!! E n√£o permite visualizamos as informa√ß√µes completas, porque a caixa de sugest√£o fica bem ali na frente e n√£o tem como remover. Tirem isso,‚Ä¶ resenha completa 	 n_util 
Infelizmente estou notando v√°rios bugs no app. As notifica√ß√µes nunca desaparecem, mesmo depois de eu j√° t√™-las visto. N√£o estou conseguindo sair de grupos que n√£o tenho mais interesse. Muitas vezes n√£o consigo nem ver todas as fotos das publica√ß√µes, por que elas n√£o abrem. Eu clico e a tela trava 	 n_util 
Basicamente todo dia tem uma atualiza√ß√£o hoje dia 17 do 11 2018 fez uma atualiza√ß√£o e n√£o entra mais em portugu√™s tirando isso qualquer coisa que a pessoa faz no Facebook fica uma notifica√ß√£o tanto ela curtiu a foto que ela tiver fazendo isso enche o saco 	 n_util 
√â muito dif√≠cil continuar usando esse App. N√£o carrega os coment√°rios, nem as publica√ß√µes. E quando atualiza a gente acha que vai melhorar e s√≥ piora . Tenho saudade do Orkut. Esse App t√° super pesado e cheio de bugs . Vou dar uma estrela pq n√£o posso zerar. 	 n_util 
Olha eu amo o facebook mas hj cedo quando eu iria logar ele no Pubg Mobile lite dava um "erro" pedia pra colocar foto de perfil √© quando eu colocava mostrava que o facebook tava verificando minha conta √© isso foi ontem √© hj por favor resolvam isso 	 n_util 
J√° faz um temp√£o que envio reclama√ß√µes pra vcs e nada, sempre a mesma resposta autom√°tica. Minha lista de "amigos que talvez voc√™ conhe√ßa" sumiu e queria ativar novamente e n√£o acho, tamb√©m tem coisas que no meu n√£o tem, configura√ß√£o moderna que s√≥ os outros tem. 	 n_util 
J√° que tem restri√ß√µes de √°udio de m√∫sicas porque voc√™s n√£o colocam um filtro para √°udio nas op√ß√µes de transmiss√£o ao vivo ? P√µe isso tamb√©m . Muitas vezes perdemos nossas filmagens por causa dos direitos autorais , at√© compreendo , mas coloquem o filtro de √°udio por favor . 	 n_util 
Depois da nova atualiza√ßao , so aparece que nao foi possivel conectar mesmo a internet estando boa , nao consigo utilizar o app , por favor arrumem isso , o facebook era unico app que eu gostava agora esta pessimoo 	 n_util 
Eu s√≥ acho q esse app nao e la muito bom para enviar videos pois enviei um video hj de uma publicidade de um evento e o app bugou sumiu os menus as fotos nao carrega ta lento demais isso tudo pq tentei enviar um video de 46s 	 n_util 
Toda hora o Facebook bloquea minha conta temporariamente e at√© uma postagem que fiz de sorvete est√£o me mandando notifica√ß√µes alegando viola√ß√£o dos padr√µes da comunidade do Facebook, pe√ßo uma explica√ß√£o sobre isso j√° que minha conta √© antiga e nunca tive esse tipo de aborrecimento com o Facebook. 	 n_util 
Gosto muito do app, o meu nem trava, roda os v√≠deos certinho e tudo mais. O √öNICO PROBLEMA √â QUE N√ÉO TA APARECENDO O AVI√ÉOZINHO, TODOS TEM ESSE AVI√ÉO, EU TBM QUERO, OUSHEEüòí 	 n_util 
ESSAS NOVAS ATUALIZA√á√ïES T√ÉO UMA CHATICE, AS NOTIFICA√á√ïES S√ì CAEM DEPOIS DE V√ÅRIOS MINUTOS E AS VEZES LEVA HORAS, ELE FICA VOLTANDO TRAVA AS VEZES. TA MUITO CHATO ISSO. me: Lenovo vibe k6 	 n_util 
N√£o sei o que est√° acontecendo com esse aplicativo s√≥ sei que depois que fez atualiza√ß√£o ele trava n√£o abre as lembran√ßas e ainda por cima t√° um lixo olha se continuar assim sinto muito mais vou abandonar 	 n_util 
Toda hora aparece as mesmas notifica√ß√µes, n√£o consigo ver curtidas pois s√≥ carrega at√© um certo n√∫mero, trava demais, toda hora entre em Ingl√™s, toda atualiza√ß√£o que tem so piora tudo, ta na hora de melhorar, jaja aparece outro app e voc√™s v√£o acabar perdendo a coroa! 	 n_util 
Fica dando erro toda hora, a internet est√° √≥tima e n√£o carrega, quer clicar para visitar o perfil de outra pessoa ou um grupo simplesmente n√£o vai. Est√° um verdadeiro lixo s√≥ ocupa espa√ßo no celular e n√£o corresponde √†s necessidades 	 n_util 
GOSTO MUITO DO FACEBOOK,MAIS DE VEZ EM QUANTO,TENHO QUE RECLAMAR DE ALGUMA,AGORA VOU ENTRAR NAS P√ÅGINAS QUE SALVEI,CLICO NA P√ÅGINA PARA VISUALIZAR ELA,E NA MESMA HORA SAI,E VAI PRO FEED DE NOT√çCIAS,ASSIM N√ÉO D√Å,N√â,OBRIGADO. 	 n_util 
Eu trabalho utilizando os grupos do Facebook, e estou perdendo muito trabalho e nem posso responder meus clientes Porque o aplicativo est√° me bloqueando, ai eu n√£o consigo comentar nada e nem publicar E sem nenhum motivo isso acontece, pfvr parem de me bloquear sem motivos. Pois √© muito constrangedo‚Ä¶ resenha completa 	 n_util 
O aplicativo est√° cada vez pior, n√£o atualiza o feed, n√£o abre as fotos quando vc clica em cima, pra sair fica s√≥ carregando, parece que piora a cada atualiza√ß√£o, j√° instalei e desinstalei v√°rias vezes pra ver se melhora e nada. 	 n_util 
T√° um lixo.N√£o configura o portugu√™s,postagens de 2 minutos aparecem que foi a 1 hora atr√°s,nao entra em outra conta (Quando voc√™ vai entrar em outra conta aparece que est√° em manuten√ß√£o).T√° tudo bugado,ou seja,a cada atualiza√ß√£o s√≥ pioraa!!!!! 	 n_util 
N√£o sei oq estar acontecendo que toda vez que abro o Facebook aparece uma nensgame dizendo "infelizmente, o Facebook parou" arrumem isso por favor, t√° uma chatice. Desde j√° agrade√ßo! 	 n_util 
Estou bloqueado e tenho essa mensagem " Isto ocorre porque houve alguma atividade incomum na sua conta. Sua conta ser√° limitada at√© 20 de dezembro √†s 01:02." como resolver esse bloqueio e voltar as atividades tranquilamente ? 	 n_util 
EU N√ÉO ESTOU CONSEGUINDO CURTIR COMENT√ÅRIOS E NEM AS PUBLICA√á√ïES, ARRUMEM ESTE PROBLEMA. N√ÉO FIZ NADA E O FACEBOOK ME BLOQUEOU E OUTRA COISA, ATUALIZEM ESSE FACEBOOK PQ CADA DIA A MAIS ELE TIRA A QUALIDADE DSS FOTOS, OBRIGADO. 	 n_util 
Eu n√£o sei o que realmente aconteceu,mas o meu perfil est√° totalmente "bugado",todos os meus amigos "sumiram",minha foto de perfil,e publica√ß√µes que fiz tamb√©m,√© como se nunca tivesse publicado nada e n√£o tivesse amigos no Facebook.Isso ocorreu ontem do nada 	 n_util 
Depois dessa √∫ltima atualiza√ß√£o do dia 18/11/2.018 n√£o recebo mais notifica√ß√µes e n√£o consigo postar fotos, fica carregando e da falha no final. Somos a aceitar atualiza√ß√£o autom√°tica sem nosso consentimento , que inferno. Parem de cagar no aplicativo a cada Nova atualiza√ß√£o e parem de nos obrigar a‚Ä¶ resenha completa 	 n_util 
De umas semanas para c√° o aplicativo vem apresentando problemas. V√°rios amigos e eu temos tido problemas com o aplicativo que mostra toda hora que tem notifica√ß√µes das quais j√° vimos. Antes aparecia toda hora que tinha 10 notifica√ß√µes, agora subiu para 50 notifica√ß√µes, sendo que n√£o tem nenhuma. Alg‚Ä¶ resenha completa 	 n_util 
√â s√©rio isso, atualiza√ß√£o toda semana e nenhuma mudan√ßa significativa, s√≥ bugs! 50MB de atualiza√ß√£o s√≥ essa semana pra nada, cada dia mais pesado. At√© a fun√ß√£o que cortava fotos pra postar tiraram, j√° a foto do perfil t√° cada vez menor, o idioma volta para o ingl√™s do nada, visualizo as mensagem e e‚Ä¶ resenha completa 	 n_util 
Olha a nova atualiza√ß√£o eh boa mas poderia ter como excluir todas as mensagens no Messenger a√≠ seria bem f√°cil de excluir aquelas mensagens do passado era melhor se tivesse como Mas a nova atualiza√ß√£o ficou muito top 	 n_util 
Eu uso o Facebook pra entrar em diversos aplicativos , pediu q eu confirmasse minha identidade agora est√£o me analisando mas est√£o demorando demais ajeitem isso logo pq estou sendo muito prejudicado com isso 	 n_util 
O meu aparelho, √© Motorola est√° p√©ssima depois da atualiza√ß√£o, dois dias que n√£o consigo fazer nada. Estou numa p√°gina e sem nada pula para outra, perco tudo que estava postando. Enfim, como fa√ßo para voltar ao anterior? O meu smartphone est√° uma M. M. M, sim 3 vezes. Boa tarde Porque tenho que atua‚Ä¶ resenha completa 	 n_util 
N√£o t√¥ conseguindo acessar meu face, s√≥ dar erro continuamente. Gostaria d ajuda, j√° vi v√°rios v√≠deos no YouTube pra resolver o problema e nenhum resolve, estou com o Facebook lite q e muito ruim. 	 n_util 
Nos √∫ltimos dias est√° mto ruim. N√£o atualiza o portugu√™s, nos compartilhamentos s√≥ fica carregando e n√£o aparece os amigos para serem marcados, fica fechando o app toda a hr. Por favor arrumem isso logo. 	 n_util 
Agora sumiu a parte das configura√ß√µes onde desativa a reprodu√ß√£o autom√°tica de v√≠deos, ou seja sou obrigada a aturar os v√≠deos reproduzindo automaticamente!! Ter que mudar a configura√ß√£o de reprodu√ß√£o de v√≠deos a cada atualiza√ß√£o do aplicativo j√° √© um saco e agora nem isso posso fazer mais!!! 	 n_util 
O APP EST√Å DANDO ERRO SEM PARAR. NAO D√Å PARA ENVIAR O ERRO NA SE√á√ÉO "AJUDA". OS FUNCION√ÅRIOS DO FACEBOOK N√ÉO RESPONDEM AS MSG PRIVADAS COM PEDIDO DE AJUDA! 	 n_util 
P√©ssimo!!! Est√° sempre pedindo atualiza√ß√£o, e a cada atualiza√ß√£o surge um novo problema, isso n√£o j√° est√° ficando insuport√°vel!!! Dsd manh√£ pedia seja bem para logar, agora aparece msg de que estou sem conex√£o, sendo que outros apps est√£o funcionando normalmente. Tr√°gico !!! üò°üò† 	 n_util 
Facebook t√° ruim de mais depois da √öltima atualiza√ß√£o n√£o consigo mais posta mais nada pra vender tudo q posto fala q vai contra as pol√≠ticas de comunidade, isso est√° causando constrangimento a v√°rias pessoas 	 n_util 
N√£o sei quanto outros aparelhos, mas no meu √© o App que mais consome bateria. Ja fiz testes desinstalando-o e pude ver a diferen√ßa. D√™em um jeito nisso, oras. Se eu fosse enumerar o tanto de contratempos que este App tem, acho que n√£o caberia aqui, nesta resenha. 	 n_util 
Aqui no Brasil muitos perfis s√£o fakes e eles distribuem mensagens e publica√ß√µes que violam os direitos humanos, j√° denunciei muitos, mas s√£o v√°rios e √°s den√∫ncias muita das vezes n√£o s√£o corretamente avaliadas pelo meu ver, estou prestes a excluir minha conta permanentemente, e voc√™ que est√° lendo ‚Ä¶ resenha completa 	 n_util 
Lixo. Exp√µe TODOS os dados pessoais dos clientes LEIGOS. Cuidado ao USAR. JAMAIS DIVULGUEM SEUS DADOS CONFIDENCIAIS EM M√çDIAS SOCIAIS. REDE RECORD FEZ REPORTAGEM SOBRE O ASSUNTO . Assistam e se informem criaturas leigas. Conselho de quem √© da √°rea de seguran√ßa. 	 n_util 
Acho Que os amigos e pessoas n√£o poderia retirar fotos do perfil.do outro para isto temos quenbloquear eles e e uma coisa que n√£o acho justo tem quem ficar aberto para os amigos ver suas fotos e postagem.maisnmuita coisa temos que privar para queneles n√£o comente e nem retire foto 	 n_util 
Meu amigo perdeu a conta dele, n√£o consegue recuperar de jeito nenhum, mandei mensagem para o suporte, por√©m n√£o respondem mais, esse chateado com isso, e quando queremos optar por receber o c√≥digo de recupera√ß√£o pelo email n√£o aparece a op√ß√£o, s√≥ aparece a op√ß√£o de c√≥digo por n√∫mero, detestavel a s‚Ä¶ resenha completa 	 n_util 
Est√° travando muito.gostaria que esse Facebook, fosse igual ao Facebook Lite, o Lite tem o mesenger e n√£o precisa baixar outro app. Vcs s√£o muito inteligentes,fa√ßa isso pra n√≥s coloca Facebook e mensager tudo junto, e bilh√µes de usu√°rios v√£o ficar muito grato, depois que colocar Facebook e mensager ‚Ä¶ resenha completa 	 n_util 
Gente melhore mais a atualiza√ß√£o nao consigo curte as fts das pessoas pesso que voces concerte isso pvf pq ta muito ruimüò†üò†üò†üò†üò† olha continua o mesmo o criador desse app arrume ele direito nossa n quer curti as postagem a p√©ssimo se ficar bom voltarei e dou outra nota mais arrume nossa lixo est√° ‚Ä¶ resenha completa 	 n_util 
Eu queria muito entender porque raios 2 contas de facebook da mesma vers√£o s√£o diferentesüòß, em um eu encontro a configura√ß√£o de contatos e midias onde eu coloco para postar meus videos em hd, e np outro simplesmente esta op√ß√£o nao existe em lugar nenhumüò§üò§üò§üò§ Porqu√™eeeeeeeeeee???? 	 n_util 
O aplicativo depois a √∫ltima atualiza√ß√£o se tornou imposs√≠vel de acessar. N√£o consigo ver nenhuma notifica√ß√£o em tempo real, a atualiza√ß√£o do feed est√° sempre muito atrasada, n√£o consigo neste momento nem abrir o App. Al√©m disso quando abri anteriormente ele estava mudando pra ingl√™s. Resolvam isso ‚Ä¶ resenha completa 	 n_util 
Srs desenvolvedores existem duas abas nesse app uma √© a do feed de not√≠cias e a outra aba √© de atualiza√ß√µes de grupo, s√≥ que as postagens de grupos ao inv√©s de aparecer nessa aba de grupos aparecem na aba do feed principal, se tem essa aba de grupos n√£o devia aparecer as atualiza√ß√µes de grupos nessa‚Ä¶ resenha completa 	 n_util 
O app est√° horr√≠vel, dando muitos erros,i tem vez que voc√™ est√° falsamente online,pois n√£o d√° pra comenta nem compartilhar nada, a√≠ voc√™ sai i n√£o consegue entra de novo 	 util 
O aplicativo n√£o abre abre a linha do tempo. S√≥ aparece "n√£o foi poss√≠vel conectar '' e as outras partes como configura√ß√µes est√° funcionando. Por favor arrumem isso! N√£o consigo ver nem postar nada! 	 n_util 
Gzuinho, t√° dif√≠cil quando vem essas atualiza√ß√µes. Nos grupos n√£o consigo ver mais todos os an√∫ncios nos grupos e muito menos dar UP para atualizar. Agora s√≥ se eu abrir um por um para atualizar. Ficou horr√≠vel. 	 n_util 
Desde ontem n√£o consigo acessar minha conta. J√° desinstalei e instalei novamente e sempre que tento entrar com a senha aparece uma mensagem que o problema √© na internet, s√≥ que a internet est√° √≥tima. Me ajudem, por favor, n√£o quero perder minha conta. üò©üò©üò©üò© 	 n_util 
Cada att fica pior! Cada vez mais in√∫til! Me fala pelo amor de Deus pq uma maldita empresa inventa de atualizar algo sem testar antes, ou com altas taxas de falhas! 	 n_util 
N√£o tenho acesso ao perfil de pessoas mencionadas em publica√ß√µes ou at√© mesmo na minha timeline, fico clicando v√°rias vezes e nada acontece. Arrumem isso 	 n_util 
Ultimamente estou tendo problemas com imagens. A aplicativo abre, mas n√£o mostra foto nem imagem nenhuma, nem v√≠deo. At√© pensei ser a internet, mas percebi ser s√≥ no Facebook. 	 util 
Gente ta t√£o Ruim que ele ta pegando direito mais n√£o quer mudar a foto do perfil fica bem um dia sem foto depois muda e ele ta apagando minhas coisas que eu p√∫blico n√£o gostei dessa vers√£o prefiro a veia resolva logo 	 n_util 
To atualizando e travou no 99/por cento e parou tudo horr√≠vel ooooMasP√©ssimo trava tudo orrivel conssome muita bateria.ocupa muita memoria etc..e ten que ficar atualuzando todo dia aja internet üò°üò°üò°üò°mas de 2horas e n√£o atualiza.s√≥ fica fazendo daulondi n√£o atualiza n√£o que atualiza o portugu√™s.. ‚Ä¶ resenha completa 	 n_util 
Aplicativo Est√° √ìtimo Mas As Notifica√ß√µes Voltar Fica Azul Como Eu N√£o Tivesse Visto As Notifica√ß√µes Antes Mostrava Um C√≠rculo Azul Na Solicita√ß√£o De Amizade Agora N√£o Aparece Mais 	 n_util 
Toda hora atualizacao. Agora para piorar o app trava direto e fecha sozinho. Vamos solucionar isso. Ja nao basta as postagens repetidas, os hor√°rios errados, agora isso. N√£o d√° para silenciar curtidas tbm. Horr√≠vel. 	 n_util 
Isso t√° p√©ssimo, tem umas publica√ß√µes grandes que aparecem a op√ß√£o "ver mais" pra continuar lendo a publica√ß√£o e quando eu clico n√£o vai ent√£o eu n√£o consigo ler as publica√ß√µes üôÑ 	 util 
Essa nova atualiza√ß√£o deixou o Facebook muito bugado, as vezes aparece notifica√ß√µes novas, mas quando eu vou ver e a mesma que eu vi a um tempo atr√°s. Ent√£o deveriam em uma outra atualiz√£o arrumar isso. 	 n_util 
Muito bom, mas de um tempo pra c√° quando o texto e grande pra ser lido, meu aplicativo n√£o quer abrir at√© o final depois do ver mais... N√£o sei se e o aplicativo ou o celular. 	 n_util 
T√° um lixo esse Facebook n√£o estou conseguindo acessar minha conta j√° troquei ate de senha mais a√≠ fala que vai me enviar um c√≥digo para acessar minha conta mais n√£o chega nada pra mim j√° faz dois dias que n√£o consigo acessar minha conta 	 n_util 
Bom o Facebook est√° com processo n√£o consigo entra e para ver minha conta nem atualizado est√° e fica dif√≠cil ver as coisas pois n√£o carrega j√° faz cinco dias que est√° assim Arrumem por favor 	 n_util 
No come√ßo era td perfeito sem problemas ;mas agora n√£o consigo curte niguem ,e fica aparecendo VC est√° tempor√°ria mente bloqueado desta a√ß√£o 	 n_util 
Boa tarde o Facebook depois q atualizou est√° bugando muito n√£o consigo por em portugu√™s est√° dif√≠cil v√™ o que vcs pode fazer para melhorar isso que passei nesta observa√ß√£o obrigado . 	 n_util 
Depois dessa nova atualiza√ß√£o, n√£o t√¥ conseguindo carregar minha notifica√ßoes, e a linha do tempo do meu perfil n√£o atualiza, √≥ feed de not√≠cias funciona normal, s√≥ esses dois detalhes que t√° me trazendo problema 	 n_util 
Nas publica√ß√µes de vendas a gente clica em ver mais e n√£o aparece, no perfil das pessoas agora s√≥ entra se apertar na foto. Est√° muito ruim. 	 util 
N√ÉO SEI OQUE HOUVE,MAS ESTE APP EST√Å HORR√çVEL! AS VEZES VOC√ä N√ÉO CONSEGUE FAZER LOGOUT,AS NOTIFICA√á√ïES APARECEM NA BARRA SUPERIOR DO TELEFONE HORAS DEPOIS... EST√Å CADA VEZ PIOR,COMO ASSIM? 	 n_util 
S√≥ trava ou nem abre estava assim no meu moto E √© agora no meu Samsung J5...cansei viu nem tenho mais paci√™ncia. Em breve excluirei minha conta 	 n_util 
E depois de ter exclu√≠do a conta por mais de dois anos....agora tenho a certeza que fiz o correto .pois hoje agora tentando abrir uma nova conta e de todas as maneiras nenhum.imail e validado...excluindo 	 n_util 
Meu facebook eles desativaram minha conta do nada sem eu ter feito nada de errado estou muito triste com isto ja at√© enviei foto do meu RG provando que sou eu mesmo e at√© agora nada estou a mais de 2 dias sem facebook estou muito triste com isto por favor resolvem isto ... 	 n_util 
Precisa melhorar a interface...atualmente pra mim est√° muito "polu√≠da". principalmente qdo colocou esse "Stories" no in√≠cio da home e agora est√° colocando at√© no meio, qdo rola a p√°gina. Enfim, est√° ruim. 	 n_util 
Olha estou aqui reclamando por que no meu celular esta falando que o portugu√™s nao pode ser usado por favor arrumem isso por que la esta falando que possi usar ingl√™s mas nao sei nada de ingles por favor arrumem isso 	 n_util 
Gosto muito desse aplicativo √© muito import√¢ncia eu acho que deveriam monitorar pessoas que usam palavr√µes no aplicativo voc√™s deveriam bloquear essas pessoas que faltam com respeito com as pessoas nada mais a declarar tenham uma boa noite Obrigado pela aten√ß√£o 	 n_util 
O site t√° dando erro minha p√°gina abre e fecha desconecta tudo sozinho aparece tela azul e login ao entra num perfil ou mudar de p√°gina horrivel 	 n_util 
Toda vez que o APP √© aberto fica aparecendo a contagem das notifica√ß√µes que n√£o foram abertas.. Arrumem isso pois antes bastava clicar nas notifica√ß√µes que mesmo sem clicar em todas n√£o ficavam aparecendo o n√∫mero no in√≠cio 	 n_util 
Toda vez que vejo as curtidas e coment√°rios das postagens e tento voltar pro mesmo, volta pra tela inicial e n√£o consigo mais acha-la üò£üò§ 	 n_util 
Sempre a aparecer os mesmos posts.. coloco like e depois vou a ver e desaparece.. dps ligo e volto a desligar e aparece novamente os mesmos postes.. √†s vezes de j√° h√° dois ou tr√™s dias 	 n_util 
Na √∫ltima atualiza√ß√£o as notifica√ß√µes n√£o est√£o aparecendo no aplicativo. Eu atualizo a parte de notifica√ß√µes e fica as mesmas notifica√ß√µes antigas! Est√° horr√≠vel!! 17/11/2018 Ainda est√° com esse bug. Est√° horr√≠vel 	 n_util 
AMEIIIIIIIIIIIIIIII MEU DEUS DO C√âU EU J√Å TINHA O FACEBOOK NOSSA AGORA QUE EU INSTALEI DE NOVO GENTE EU PIREI QUANDO VI TINHA MUITAS COISAS RUINS E AGORA ELES MUDAR√ÉO TUDO EUUUUUUUUUUU AMEIIIIIIIIIIIIIIII QUANDO EU VI NOSSA INSTALEM SE N√ÉO VCS V√ÉO TER QUE POR ISSO QUE VOU ESCREVER #OI CARA DE BOI Aa‚Ä¶ resenha completa 	 n_util 
A op√ß√£o "ver mais" n√£o est√° funcionando vc clica e n√£o abre , pessoas marcadas em coment√°rios vc clica e n√£o tem acesso ao perfil , ficou p√©ssimo isso vc quer continuar lendo algo e n√£o pode 	 n_util 
O app est√° p√©ssimo quando vou abrir um v√≠deos as vezes sai √°udio as vezes n√£o e o problema n√£o e o cll pq vejo MTS v√≠deos no YT e n√£o trava o √°udio ent√£o arrumem isso pfv 	 n_util 
Essa atualiza√ß√£o ta horr√≠vel, eu coloco s√≥ pra meus amigos olharem minhas publica√ß√µes e mesmo assim tem gente que n√£o e' amigo do face vizualiza curte e compartilha...arrumem isso... Ja coloquei s√≥ pros amigos olharem e n√£o adianta ...arrumem isso por favor 	 n_util 
App muito pesado e mal estruturado. Poderiam simplificar o layout e as fun√ß√µes para um app mais fluido e √∫til, pois de nada adianta ter tantas fun√ß√µes se a maioria trava e interfere at√© no funcionamento de outros apps. 	 n_util 
N√£o gostei, uso no celular e esta barra em cima ou no rodap√© n√£o deveria aparecer..pessimo.parece um app infantil..os meus grupos foram apagados s√≥ tem o simbolos..e muitas propagandas..Usava mais para os meus grupos agora que sumiram vou usar menos o face! Parece muito poluido e logo cansa! Pessimo‚Ä¶ resenha completa 	 n_util 
Bem q podia ter um aceso pra n bloqueado as pessoas no msg junto com o face... Da√≠ minha nota era 5 estrelas üòèüòç Poderia tamb√©m pra bota silencia story do face ne 	 n_util 
Os v√≠deos est√£o ruim, a parte do sininho tudo hora fica aparecendo notifica√ß√£o sendo que n√£o tem, t√° ruim pensei que iria melhor, mais s√≥ piorou. 	 n_util 
Mim falar um coisa pq onden marda convite etc. N√£o mudar s√≥ meu que t√° assim meu t√° vers√£o antiga üíîüíîüíî tem novo vers√£o meu Nd quando chegar nova a√≠ vem novo üò†üò†üò† palha√ßaüò†üò† 	 n_util 
A nova interface ficou gigante e feia, e deviam esperar pelo menos um pouco ao inv√©s de ficarem mandando actualiza√ß√µes a cada 1 hora 	 util 
Desde da √∫ltima atualiza√ß√£o n√£o consigo ver as notifica√ß√µes, aparece apenas a quantidade, mas quando clico aparece os anteriores no caso o de domingo. Tento atualizar, mas n√£o tenho tido sucesso, tenho que acessar no PC ou notebook para poder ver. 	 n_util 
Estou com dificuldades para curtir publica√ß√µes e coment√°rios! Ele me informa que "essa a√ß√£o est√° bloqueada temporariamente"! Gostaria de saber do que se trata e como resolver esse problema por favor?! 	 n_util 
N√£o consigo mais entrar e, quando finalmente entro n√£o consigo deslogar minha conta. Est√° imposs√≠vel usar esse aplicativo, vou desinstalar e entrar pelo navegador mesmo. 	 n_util 
Ningu√©m, NINGU√âM QUER SABER SE UMA PESSOA QUE C√ä NUNCA VIU NA VIDA TAMB√âM COMENTOU O COMENT√ÅRIO DE FULANA DE TAL 	 n_util 
Essa √∫ltima atualiza√ß√£o tirou o √≠cone que d√° acesso r√°pido ao meu pr√≥prio feed, coloquem de volta pois foi a melhor coisa que fizeram e agora n√£o tem mais 	 n_util 
A √∫ltima atualiza√ß√£o n√£o abre os an√∫ncios do Marketplace. Quando carrego num an√∫ncio, aparece apenas a imagem do artigo e a seta para recuar. N√£o permite fazer nada e obriga-me a ir ao computador de prop√≥sito para ver os artigos corretamente. 	 n_util 
no meu huawei p8 lite sempre que abro aparece muitas notifica√ß√µes por segundos e depois aparece 0 e sempre que fecho e abre faz o mesmo, que raio de face bugado üòïüòî 	 n_util 
Cada atualiza√ß√£o que √© feita, vem um defeito novo. Eu tenho um p√°gina e est√° horr√≠vel para administrar. Fora que o app me notifica de coisas que j√° vi. 	 n_util 
Eu curto o Facebook , por√©m arrumem os bugs que est√° dando , n√£o carrega as postagens, nos an√∫ncios e isso √© chato. Arrumem essa atualiza√ß√£o novata que est√° um pouco complicada. 	 n_util 
AGUEM ME AJUDAR!! A PARAR DESSE INFERNO DE TAMTO COMECIAL NO FACE.. PORFAVOR... EU SOU DE OBRIGADO A VER ESSAS DESGRA√áA DE COMECIAL ??? 	 util 
Odeio falar assim, mas que a verdade seja dita ... Esse aplicativo √© horr√≠vel, p√©ssimo sempre travando e agora parou de vez n√£o abre mais. üò†üò° S√≥ fica carregando e n√£o carrega nada Atualiza toda semana e n√£o melhora em nada s√≥ piora Pelo amor de Deus, os desenvolvedores desse aplicativo deveria pre‚Ä¶ resenha completa 	 n_util 
Coloca esse emoticon ü§¶üèº‚Äç‚ôÄÔ∏è na rea√ß√£o, ele faz falta. E precisamos d uma carinha sorrindo mas com os olhos tristes nos emoticons. A√≠ fica perfeito 	 n_util 
N√£o consigo atualizar as notifica√ß√µes, n√£o consigo ver os coment√°rios, s√≥ fica carregando. E agora, apoia essa nova atualiza√ß√£o, piorou, pois nem carrega mais o aplicativo 	 n_util 
Hoje pela manha entrei normalmente na minha conta,agora n√£o quer entrar esta bloqueada.ARRUME POR GENTILEZA PRECISO ACESSAR MINHA CONTA 	 n_util 
Amigos do face n√£o conseguem responder meus coment√°rios que o celular trava quando clicar responder me ajudem a resolver isso por favor n√£o sei o que fazer!!? 	 n_util 
Oque aconteceu com essa √∫ltima atualiza√ß√£o??? A gente clica na notifica√ß√£o e n√£o vai pra lugar nenhum!! Se quiser ver oq a notifica√ß√£o est√° avisando, tem q procurar a publica√ß√£o!! Muito ruim isso!!!! 	 n_util 
Vcs adicionam coisas desnecessarias que consomem mais processamento. Como a aba Marketplace e a de Live. Desnecessario deveria ser opcao do usuario colocar 	 n_util 
Pelo amor de Deus esse facebook s√≥ atualiza e o mesmo erro nunca "sai" (No momento,n√£o foi poss√≠vel configurar o portugu√™s.) 	 n_util 
No meu aparelho nao aparece a op√ßao de como estou me sentindo. Ja desinstalei e intalei d novo e o erro permanece. Como soluciono esse problema? 	 n_util 
Tem um bug que voc√™s precisam urgente arrumar! Quando coloco a op√ß√£o de ocultar mensagem ele n√£o oculta e mant√©m a mensagem! Por favor arrume isso. 	 n_util 
Depois da √∫ltima atualiza√ß√£o ele diz que n√£o foi poss√≠vel configurar o portugu√™s e quer que eu utilize em ingl√™s, se eu n√£o aceitar ele n√£o entra. Resolvam!!!! 	 n_util 
√â bom mas tem um problema na area de reagir a publicacoes e comentarios por esta meio travado e n tem como reagir com GRR mas √© so isso mesmo;-; 	 util 
Consome muita mem√≥ria!sem contar q n√£o da para visualizar o Messenger e se baixa vai a mem√≥ria toda saudades em q podia usar os dois Messenger e o face junto no aplicativo android nem no navegador est√° podendo usar Messenger üòë 	 n_util 
Essa nova atualiza√ß√£o do App est√° p√©ssima, n√£o carrega quase nada, n√£o abre as fotos e v√≠deos, e est√° dando erros e fechando o aplicativo sozinho (Samsung S7) 	 n_util 
Toda vez que eu tento atualizar minha foto do perfil ele trava...ou quando vou fazer alguma publica√ß√£o tamb√©m falha 	 n_util 
Bom dia! O Facebook √© um dos melhores app de rede social. Mais eu tenho uma sugest√£o. As vezes n√≥s usu√°rios tomando decis√µes de privacidade que depois acabamos nos arrependendo, e n√£o sabemos como deixar como era antes. Tenho uma sugest√£o para isso seria poss√≠vel desenvolver um bot√£o com o nodo de r‚Ä¶ resenha completa 	 n_util 
Eu n√£o tenho no√ß√£o do pq de um aplicativo de uma empresa como o Facebook ser t√£o cheio de bugs. Ultimamente t√° com problema pra mostrar as notifica√ß√µes. Toda vez q eu abro o app aparece que eu tenho 9 notifica√ß√µes novas (fica aquele c√≠rculo vermelho no sininho), s√≥ q s√£o sempre coisas q eu j√° vi. Al‚Ä¶ resenha completa 	 n_util 
Meu Deus Facebook, meus amigos me convidaram pra entrar nos grupos, mais quando eu clico em participar do grupo ele voltar pra p√°gina inicial meu Deus arruma essa drogaüòíüòí 	 n_util 
P√©ssimo , Depois da atualiza√ß√£o chega a notifica√ß√£o na barra do telefone mas quando vou abrir o App, n√£o aparece absolutamente nada üòí 	 util 
Muito demorado e atualiza o tempo todo para umas fun√ß√µes desnecess√°rio est√° acabando com a ess√™ncia do Facebook sinto que utilizo uma r√©plica do Instagran e me faz optar por um outro pq est√° quase igual sendo que o bom √© diferenciar 	 n_util 
Hello,i have a problem...i clean everything on my tablet,but now i can not open the Facebook app(i can open Messenger)can you guys hello me ,please 	 util 
Ola Hackearam a conta do meu filho e a cinta esta com outra senha e outro n√∫mero de telefone oq eu Fa√ßo? 	 util 
O Facebook em vez d melhorar est√° √© piorando toda hora sai √© aparece q est√° com problemas,quando isso se resolver dou 5 estrelas 	 n_util 
Vamos melhorar esse APP pois est√° muito ruim, tem hora q √± abre nem carrega nada como se √± estivesse Internet. Mas tem. Tenho q apagar o cache toda hora pra voltar ao normal, melhorem isso! 1 star 	 util 
T√° ruim viu acabei de reinstalar ele e j√° est√° dizendo que o app n responde sendo que nem coloquei minha senha pra entrar ainda! 	 n_util 
O Facebook junto com Instagram perderam o respeito com seus usu√°rios. Feed, stories, visualiza√ß√£o de v√≠deos todos carregados por muita propaganda. Deveria ser algo opcional. 	 n_util 
Toda vez que eu entro na parte de jogos, o aplicativo trava e sai, espero que na pr√≥xima atualiza√ß√£o arrumem isso. 	 n_util 
Tem alguma maneira que eu possa entrar em contato com o Facebook? N√£o sei oq est√° acontecendo ainda estou com problema 	 n_util 
O Facebook bloqueou a lojinha n√£o tenho acesso a nada. E s√≥ vive atualizando. Vive travando. Seria poss√≠vel desbloquear o Marketplace. 	 n_util 
Estou levando mais de uma hora p atualizar minha foto de perfil, essa √∫ltima atualiza√ß√£o est√° horr√≠vel... 	 util 
Tamb√©m tornou se nativo do sistema Android, s√≥ pode ser desativado, mas mesmo assim suga bateria, fornece dados pessoais ao Google inclusive a localiza√ß√£o, √© praticamente desprez√≠vel, ningu√©m usa, e a funcionalidade √© pr√© hist√≥rica, v√≠deo p√©ssimo, chamadas com voz rob√≥ticas e picotadas, devia ser pe‚Ä¶ resenha completa 	 n_util 
Hoje come√ßou a fechar sozinho, eu trabalho com minha conta particular e uma empresarial do Google apps. J√° removi e instalei novamente por√©m n√£o resolveu, segue fechando sozinho, estou usado o chat for hangouts por√©m s√≥ funciona para a conta empresarial. 	 n_util 
Sugiro que aprimorem o app. Ele n√£o notifica, n√£o mostra com precis√£o se o usu√°rio est√° online. Aparece "ativo agora mesmo" quando na verdade o usu√°rio n√£o est√°. Sugiro outras fun√ß√µes como poder mandar √°udio ou editar (recortar) as imagens que ser√£o enviadas. 	 n_util 
Daniel mello √© mentira eu mando foto v√≠deo e etc e vai rapidinho antes de vc vir falar que o Google s√≥ lan√ßa aplicativo ruim ent√£o esse aplicativo de estala coisas tamb√©m como vc disse o Google s√≥ lan√ßa coisa esse aplicativo Tamb√©m √© ruim n√© deve ser seu celular que est√° com problemas n√£o o aplicati‚Ä¶ resenha completa 	 n_util 
No meu S3 ap√≥s a √∫ltima actualiza√ß√£o deixaram de se ouvir notifica√ß√µes e n√£o permite enviar sms de grupo. Penso que s√£o grandes falhas que me obrigaram a mudar de aplica√ß√£o. 	 n_util 
S√≥ valeria a pena se Android migrasse todos os torpedos e o aplicativo de origem fosse substitu√≠do pelo hangouts. Voc√™ usar dois aplicativos que manipulam sms n√£o faz sentido algum. 	 n_util 
Esta app √© um perigo mesmo depois de bloquear a pessoa com quem se falava essa pessoa mant√©m nossas fotos e hist√≥rico e n√£o podemos fazer nada para apagar nossas fotos e impedir que a outra pessoa que bloqueados as veja e use 	 n_util 
O aplicativo precisa de melhorias, algumas j√° foram citadas pelos usuarios abaixo..eu gostaria de poder apagar uma determinada mensagem na vonversa e nak √© poss√≠vel.. por ex . 	 n_util 
Poderia ter a op√ß√£o de ignorar e n√£o somente bloquear as pessoas . Outra coisa que n√£o tem √© a exibi√ß√£o de contatos nem aqueles que tem este app mas a cada dia vejo melhorias √≥timas. 	 n_util 
√â um √≥timo aplicativo de conversa,mas tem um pequeno problema porque n√£o mostra corretamente o hor√°rio de quando a pessoa esteve online. Isso me incomoda bastante, por favor, consertem isso logo. Obrigado. 	 n_util 
Gosto de pensar no Hangout como um canal de comunica√ß√£o um pouco mais seletivo e fechado, ao qual eu reservo para manter contato com pessoas mais relevantes para mim. Funciona como um meio alternativo. Combinado com outros meios dispon√≠veis. Representa algo mais afetivo. N√£o penso tanto em funcional‚Ä¶ resenha completa 	 n_util 
Mt bom mais esses dias meu teclado n√£o est√° funcionando direito,como por exemplo eu vou digitar e do nada o teclado sai da tela, e isso ficou se repetindo at√© hj 	 n_util 
N√£o quero interromper o teu silencio ao pai, mais √© s√≥ orando que eu encontro paz, o vento da afli√ß√£o quero apagar a chama da minha adora√ß√£o, ACALMA O MEU CORA√á√ÉO ACALMA O MEU CORA√á√ÉO 	 n_util 
Horr√≠veeel,p√©√©√©√©ssimoooooooooooo,at√© essa data que eu registro a minha opini√£o,quanto a esse aplicativo.A n√£o ser que ap√≥s registrar aqui,eu use,ele me prove algo bom em que ele possa me surpreender 	 n_util 
Gosto muito d aplicativo recebo notifica√ß√µes sim e ainda padronizei para cada amigo. Envio de fotos √© super r√°pido. So gostaria q tivesse a fun√ß√£o de enviar √°udio. 	 n_util 
Gosto muito do aplicativo ajuda muito, o problema dele √© que ele n√£o mostra a notifica√ß√£o de quando recebo mensagem se eu n√£o abrir o app para v√™ as mensagens n√£o fico sabendo se tem. 	 n_util 
N√£o imaginava que existia ate se tornar nativo, ai conheci e odei, pois assim comoveu ningu√©m usa isso, al√©m de ser muito ruim. 	 n_util 
Agora s√≥ consigo fazer v√≠deo confer√™ncia com meus contatos, esta cheios de aplicativo para isso. J√° foi nota 5, o melhor de todos quando conseguia fazer v√≠deo confer√™ncia livre, para todos. 	 n_util 
Google, o Hangouts poderia inserir novas op√ß√µes de compartilhamento. √â muito necess√°rio e comum compartilhar PDFs, DOCX, PPTX, MP3 pelo mensageiro, por√©m isso ainda n√£o √© poss√≠vel aqui, poderia enviar mensagem de audio, notificar corretamente e hora quando se recebe mensagem. O hangout √© o √∫nico que‚Ä¶ resenha completa 	 n_util 
Vem melhorando, mas ainda perde feio pro bom e velho, simples e pr√°tico, espartano mas completo Gtalk. Pena ter sido substitu√≠do "por isso". 	 n_util 
N√£o consigo fazer chamada de voz, conforme fala na descri√ß√£o do app!! Ouvi dizer que s√≥ tem essa op√ß√£o para IOS! Acho um absurdo isso! 	 n_util 
Pra ficar melhor tem que instalar o Google Tradutor no app hangouts pra tradu√ß√£o em tempo real v√≠deo chamada com tradu√ß√£o em tempo real a√≠ sim estar√° perfeito Al√¥ pessoal equipe do roubo isso a√≠ mandou a do Google coloca a fun√ß√£o toque para traduzir o Hobbit A pessoa manda passar um texto para mim i‚Ä¶ resenha completa 	 n_util 
Voc√™s poderiam melhorar o App??? Todas as fun√ß√µes s√£o ruins, chamada de v√≠deo,voz, envio de arquivo ... Coloquem envio de √°udio por favor! Abra√ßosüòÅ 	 n_util 
Deveria ter a op√ß√£o de desinstalar de vez do telefone, n√£o tenho a obriga√ß√£o de ter algo que n√£o uso ocupando espa√ßo desnecess√°rio em meu celular .... 	 n_util 
Gostaria que ele pudesse apagar msgs como WhatsApp da sua conversa e do outro indiv√≠duo sem apagar a conversa e tbm pudesse salvar o antigo restaurar o hist√≥rico de conversas √© isso 	 n_util 
N√£o uso,pra mim n√£o serve. N√£o sei porque n√£o podemos desinstalar do celular,s√≥ ocupa espa√ßo e suga bateria,afff 	 n_util 
O app n√£o envia √°udio,e quando ver quando a pessoa tava online mostra o hor√°rio errado, por favor corrijam isso. 	 n_util 
N√£o tem como desligar, mais um parasita do Android, apenas a vers√£o do PC que tem no Gmail presta, acredito que deveriam aprender com o que j√° funciona 	 n_util 
√© muito lento e n√£o d√° para fazer uma chamada se fazer ruidos mas acaba para dar para o que serve que √© cumunicarmos uns com os outros online 	 n_util 
Na minha experi√™ncia √© melhor que o Messenger nas chamadas de voz. Peca por ser complexo os pedidos de amizade e no envio de fotos... 	 n_util 
N√£o sei se devo dar j√°, s√≥ agora vou fazer a experi√™ncia. Veremos no futuro. 	 n_util 
Poderia melhorar o sistema de recebimento de mensagens, avisando quando a mensagem chegou no dispositivo da outra pessoa, fora isso, n√£o vejo outros problemas 	 n_util 
Eu gosto desta aplica√ß√£o porque √© fixe e d√° para enviar m√∫sicas e fazer video chamada eu adoro esta aplica√ß√£o! !üòò 	 n_util 
Muito retr√≥grado. N√£o d√° para procurar mensagens na conversa, selecionar, excluir, favorita as mensagens e ainda suga toooda a bateria 	 n_util 
Fechando o app do nada, e pedindo feedback a todo momento, eu preciso ver, nao esta chegando notificacoes tbem. 	 n_util 
Quando voc√™ liga pra algu√©m ou faz chamada de v√≠deo na chamada de v√≠deo e bem n√≠tido, d√° pra ver tudo e na liga√ß√£o d√° pra escutar as coisas melhor que a liga√ß√£o do WhatsApp 	 util 
Quando tento entrar em uma conversa, ele abre a p√°gina do app e minhas conversas antigas e n√£o funciona. 	 n_util 
Uso a mais de 5 anos e nunca tive problemas. Oferece um excelente servi√ßo e atende bem as necessidades. 	 n_util 
Eu acho que o hangouts deveria ser igual o Whatsapp , que desse para mandar audio , fizesse story etc... 	 n_util 
Aqui tem muitos homens sarados mas qdo n√£o quero mais. excluo...√â legal kkkkk 	 n_util 
N√£o est√° aparecendo as carinhas animadas qnd tira ft, pro stories ou qqr coisa assim 	 n_util 
agora o whatsapp e/ou outro aplicativo de voz cumpre este papel. N√£o o deixo ativo. 	 n_util 
Eu gosto do Hangouts, por que pessoas como eu que ainda n√£o tem WhatsApp podem usar o Hangouts 	 n_util 
Muito bom. Mas a qualidade da videochamada n√£o √© muito grande. Por outro lado, o sistema de mensagens √© muito bom. 	 n_util 
eu amo hangouts mas deveria ter √°udio para mandar mas amo o app‚ù§üòç parab√©ns criadores 	 n_util 
Deve ser corrigido as vozes de rob√¥s e que podessemos enviar √°udio, m√∫sicas,e queria poder desativar quando quisesse 	 n_util 
Incr√≠vel fant√°stico. Podia at√© criar um canal no YouTube falando deste APP 	 n_util 
N√£o √© poss√≠vel fazer chamadas de voz no Android, coisa que fazia direto com meu iPhone. Inclusive tenho cr√©ditos q agora s√≥ posso usar do computador, mudem! 	 util 
Consome muito energia e falta op√ß√£o gravar √°udio e com alguns bugs para enviar mensagens 	 n_util 
Totalmente desnecess√°rio neste aplicativo aqui n√£o utilizo e est√° ocupando espa√ßo no aparelho. 	 n_util 
Gosto muito do App mais √© ruim que n√£o manda √°udio e n√£o apaga as conversas 	 util 
O App √© muito bom, mas nas liga√ß√µes ele as vezes trava e fica meio lento, mas, fora isso, eu recomendo! 	 util 
Muito bom, por√©m funciona apenas conectado √† internet. Poderia funcionar com cr√©dito das operadoras. 	 n_util 
Ola olha eu adorei o hangouts oque falta mesmo e a grava√ß√£o de voz 	 n_util 
Este app e muitl bom 	 util 
seria bacana poder enviar audio tambem. configura ai. muito bacana. podem baixar. 	 n_util 
Acho que √° √∫nica coisa que estraga √© n√£o poder mandar √°udio 	 n_util 
N√£o recebo notifica√ß√µes, n√£o vibra e nem toca. S√≥ funciona no computador, no meu celular, n√£o. 	 n_util 
Deveria ser parecido com o zap. 	 util 
Adoro ele, mas gostaria de mandar √°udios atrav√©s dele 	 n_util 
Essa pocaria ta s√≥ enchendo a mem√≥ria do meu celular 	 n_util 
Muito bom, mais precisa dar uma atualizada nos emojis. 	 util 
Eu gosto do aplicativo. S√≥ falta liberar a grava√ß√£o de √°udio. 	 n_util 
Um app s√≥ pra evitar msg mais nada! 	 util 
√â um Zap! Por√©m n√£o tem mensagem de voz 	 n_util 
Pena que vai parar de funcionar. Muito bom principalmente em v√≠deo confer√™ncia. 	 n_util 
P√©ssimo, tinha que ter uma op√ß√£o para bloquear os indesej√°veis. 	 n_util 
E muito bom 	 util 
N√£o uvei mais gosteiüíùüíï 	 util 
Eu particularmente usava celular s√≥ pra falar, hoje uso pra tudo nota 1000 	 util 
Na distancia aproxima os amigos e criamos novos amigos distantes 	 n_util 
Eu gostaria que fosse poss√≠vel excluir as fotos enviadas no App. 	 n_util 
Assim que poss√≠vel avaliarei, vou come√ßar a usar... üëç 	 n_util 
Eu amei esse app‚úåüòç 	 util 
Estou querendo usar este app m√°s n√£o seio como 	 n_util 
Parou de avisar tem que ficar entrando na conversa pra ver se chegou alguma msg 	 util 
Pessimo e um dois piores que eu ja vir 	 util 
Deveria ter a fun√ß√£o de mandar √°udio igual do Whatsapp 	 n_util 
Sou obrigada a ter esse aplocativo que pra mim √© inutil ocupando memoria 	 util 
Seria melhor se fosse poss√≠vel enviar mensagens de √°udio tamb√©m 	 util 
Eu sla ele fareis bom las bom mas 	 n_util 
√â bom mas eu s√≥ uso as vezes 	 n_util 
gosto do hangouts mais nuca da o qeu ajente escreve por quem 	 n_util 
√â muito bom mais o ruim √© que n√£o d√° para apagar 	 n_util 
S√≥ serve para ocupar mem√≥ria do celularr 	 n_util 
N√£o aprendi a usar esse recurso 	 n_util 
Gostei muito Bom ir simples de se usar .. 	 n_util 
Nossa Senhora foto de gato pequeno para foto de gato para tirar foto nenhuma 	 n_util 
Poderia ter a op√ß√£o de enviar √°udios. Grata! 	 n_util 
ainda n√£o usei √© muito dif√≠cil 	 n_util 
Chato s√≥ ocupa espa√ßo no celular üò° 	 n_util 
Me sentindo muito feliz. 	 n_util 
Eu ainda n√£o sei vou usar 	 n_util 
Simples ,mas eficiente no que se prop√µe 	 n_util 
Poderia ter uma pasta onde guardamos nossas mensagem recebidas 	 n_util 
#convidativo , muito bom!!! 	 n_util 
Passei a usar a pouco tempo mas tou gostando 	 n_util 
Gosto s√≥ faltou msn √°udio 	 n_util 
Temos que ter a op√ß√£o de deletar mensagem e tamb√©m temos que ter mais opcoes para enviar fotografias 	 util 
√â bom 	 util 
Depois que atualizou a liga√ß√£o e chamada de v√≠deo ficou mudo 	 n_util 
Muito bom 	 util 
Amor e fe 	 util 
Leve, pr√°tico e abre junto com o Gmail . √ìtimo para quem est√° constantemente conectado no e-mail. 	 util 
Eu quero adicionar um contato 	 n_util 
Gostaria que este app fizesse chamada de v√≠deo e pud√©ssemos enviar clip de voz 	 util 
Com certeza sem tanta democracia mais f√°cil adicionar do ke o zapp 	 util 
Acho que deveria colocar a opcao de apagar a mensagem tanto pra vc tanto pra outra Pessoa 	 util 
E bom s√≥ que era bom se tivesse como manda audio mas amei 	 util 
Esse aplicativo e muito melhor pra mim 	 n_util 
√â bom, mas podia melhorar 	 n_util 
N√£o atualiza quando foi a ultima visualiza√ß√£o 	 n_util 
Talvez seja bom vou usar agora 	 util 
Muito bom! 	 n_util 
Toma espa√ßo no celular n√£o tenho tempo para us√° 	 n_util 
√â bom pois √© quase um watszapp 	 n_util 
Vo mandar todos voc√™s pra toma no seu cu 	 util 
Gosto daqui principalmente pra conversar com pessoas fora do Brasil 	 util 
Lindo muito lindo esse Apia√≠ muito lindo lindo lindo lindo lindo lindo mesmo n√£o tenho muitas palavras porque voc√™ √© muito legal legal legal legal legal 	 util 
√ë entendo bem esse app 	 n_util 
Tem alguns problemas, m√°s da pra usar 	 util 
Nao baixe esse app pessimo nao envia mensagen 	 util 
N√£o tenho interesse n√£o gosto 	 util 
Muito falho, principalmente por n√£o ter op√ß√£o de enviar √°udio. 	 util 
√â bastante bom s√≥ a voz √© que √© n√£o fica bem. 	 util 
Vao cria um jogo imves disso 	 util 
Da pra flar com meu papai com video 	 util 
Muito otimo ameei e amei muito 	 util 
Voc√™ poderia fazer um v√≠deo reagindo a anima√ß√µes 	 util 
No meu tablet n√£o d√° para atualizar 	 util 
√â incrivel! √â praticamente um Whatsapp s√≥ que mais antigo 	 util 
N√£o posso avaliar pois ainda vou testalo 	 util 
Por favor n√£o desejo receber mais atualiza√ß√µes 	 util 
Keep on with good work 	 n_util 
√â bom Mas eu n vou escrever resenha curta aqui Se eu quiser eu escrevo a b√≠blia aki Vc n manda em mim google LLC OLHA S√ì O VERSICULO DO DIA N√£o se far√° mal nem dano algum em todo o meu santo monte, porque a terra se encher√° do conhecimento do Senhor, como as √°guas cobrem o mar. Isa√≠as 11:9 Poderdes ‚Ä¶ resenha completa 	 util 
Vou usar ainda 	 n_util 
Legal muito legal 	 util 
Mais ou menos 	 util 
Eu quero gravar audio!!!!! N√£o tem como? 	 util 
Gosto muito, obrigada !!! 	 n_util 
√ìtimo! D√° pra mandar mensagens, emojis e telefonar de boa! 	 util 
Hangouts √© tudo de bom üòé 	 n_util 
N√£o quero em meu celular 	 n_util 
Este app √© dez, satisfa√ß√£o plena. 	 util 
Gostei MT de usar perfeitinho. 	 util 
Desde a √∫ltima actualiza√ß√£o que n√£o consigo enviar mensagens para ningu√©m. Se for mensagens curtas de uma s√≥ palavra d√° para enviar, mas se a mensagem tiver mais que uma palavra a aplica√ß√£o vai abaixo, ficando o ecr√£ a branco, e volta ao estado normal, mas mesmo assim n√£o envio mensagens. J√° reinici‚Ä¶ resenha completa 	 n_util 
Desde a nova atualiza√ß√£o a app est√° sempre a dar erro, n√£o consigo apagar mensagens, e quando quero enviar uma mensagem d√° logo erra da App, muito descontente, a App era muito boa, estava a adorar, desde que atualizei virou lixo. Corrijam por favor 	 n_util 
Atualizou √† pouco tempo e desde a√≠ que ao enviar mensagens a aplica√ß√£o para e fecha, a mensagem aparece como enviada mas n√£o √© mesmo enviada. Muito mau! Resolvam isso! 	 n_util 
Gostei do a app, mas toda vez da erro no envio da mensagem e demora muito pra enviar , todaves fala que o app parou e j√° tentes dessistala para tenta repara o erro, mas ele √© o app do sistema . 	 n_util 
Precisa permitir selecionar v√°rias mensagens (de uma mesma pessoa) para apagar. Atualmente, o App s√≥ permite apagar uma de cada vez. Quanto a mensagens de destinat√°rios diferentes permite selecionar v√°rios. 	 n_util 
Muito bom amei recomendo parab√©ns aos desenvolvedores amei essa nova atualiza√ß√£o parab√©ns mesmo pelo empenho de vcs fazer o aplicativo mensagem bem melhor agora üëçüëçüëçüëçüëèüëèüëèüëè 	 n_util 
Esta funcional vamos ver na hora da necessidade... se vai travar ou n√£o testes rodou bem... 	 n_util 
Desde a √∫ltima atualiza√ß√£o que d√° sempre erro no envio de sms 	 n_util 
Muito bom. Uso diariamente, mas tem dado muito erro ultimamente. 	 util 
Muito bom ! 	 n_util 
Ta bom 	 util 
Muito bom 	 n_util 
Pesquisa n√£o funciona 	 util 
Muito bom, 	 util 
Muito bom 	 util 
Otimo 	 n_util 
Otima 	 n_util 
√ìtimo 	 util 
Muito ruim as mensagens enviadas n√£o chegam aos destinat√°rios,vamos resolver este problema.De que adianta um aplicativo que n√£o funciona. 	 n_util 
N√£o entendi nada tem que pagar 	 n_util 
√ìtimo para mandar mensagens de texto. 	 n_util 
Show de bola. 	 n_util 
√ìtimo 	 n_util 
Adorei 	 n_util 
Por favor pe√ßo que resolvam estou tendo problemas em enviar mensagens as vezes ficam e n√£o s√£o enviadas e a op√ß√£o de enviar contato (inserindo no texto de msg) n√£o est√° boa porque converte a mensagem em MMS e aqui onde estou n√£o funciona o servi√ßo. Nokia 3 - android 8.1 	 n_util 
Apesar das considera√ß√µes anteriores, o app est√° decepcionando ap√≥s a atualiza√ß√£o para o Android Oreo 8.1. Eu tenho certeza que tem um grande potencial por√©m est√° me deixando na m√£o. N√£o consigo enviar SMS com regularidade e os MMS t√™m dificuldade de envio, desde antes da atualiza√ß√£o, mesmo com o sin‚Ä¶ resenha completa 	 n_util 
Desde que foi actualizada em outubro estou sempre a ficar com mensagens que n√£o s√£o enviadas e ficam "penduradas" e nem percebo isso. Deixou de ser seguro mandar mensagens pois nunca sei se s√£o entregues ou n√£o. Mais algu√©m tem tido esse problema? 	 n_util 
Ap√≥s a √∫ltima atualiza√ß√£o j√° n√£o √© poss√≠vel efetuar diretamente a chamada para o n√∫mero com quem se est√° a trocar mensagens, por favor melhorem isso. A aplica√ß√£o melhorou bastante. Acho que n√£o precisava de dizer iniciar chat bastava s√≥ o s√≠mbolo para se iniciar uma conversa nova. Outro aspecto que ‚Ä¶ resenha completa 	 n_util 
Olha... Como o google for√ßa a utiliza√ß√£o deste App... Inclusive bloqueia a desinstala√ß√£o! N√£o tem outra alternativa... Se instalar o root at√© d√° pra tirar mais perde a garantia! ü§∑üèª‚Äç‚ôÇÔ∏è 	 util 
Tudo funciona como esperado sem problemas, e at√© tem um design bonito e original da Google, por√©m a notifica√ß√£o de mensagem que aparece no canto superior do ecr√£, quando clico no bot√£o responder, muda a p√°gina onde j√° estava para uma toda em preto, onde, a√≠ d√° para responder atrav√©s da notifica√ß√£o. ‚Ä¶ resenha completa 	 n_util 
Est√° verso est√° com problemas de recebimento de mensagens, quando ativo ele como APP padr√£o pra msgs depois fico sem receber as mensagens porque elas simplismente n√£o entram quando me s√£o enviadas. 	 n_util 
Uma aplica√ß√£o que ainda tem muito para melhorar. Deviam implementar a fun√ß√£o de enviar mensagens programadas, pois √© bastante util. O pior mesmo, √© a fun√ß√£o de funcionalidade de chat n√£o funcionar. Resolvam isso r√°pido por favor... 	 n_util 
S√≥ uso o servi√ßo de mensagens pra conversar e achei legal a atualiza√ß√£o. N√£o possuo redes sociais, logo meu "joinha" vai s√≥ pro chat mesmo 	 n_util 
Eu n√£o tenho o que reclamar porque esse aplicativo j√° veio no meu celular quando eu comprei ele... Pra mim ele √© meu bom... Como o meu celular √© da Motorola Moto G5S normal ent√£o para mim ele √© muito bom... As pessoas recebem e mandam mensagens para mim... 	 n_util 
Eu atualizei o aplicativo e agora os destinat√°rios n√£o recebem as mensagens, √ìTIMO!!! O PIOR APLICATIVO QUE PODERIA EXISTIR. FEEDBACK PARA QU√ä, VOC√äS NAO ATENDEM UMA SEQUER SOLICITA√á√ÉO 	 n_util 
App confuso de cores. N√£o se sabe onde digita contato e texto. Sem falar que o app est√° anos luz atr√°s do WhatsApp, Facebook Messenger, Skype, Telegram e at√© outros recursos do pr√≥prio Google, como o Allo e Duo. 	 n_util 
Bom, mas pode melhorar. S√≥ envia mensagem do tipo MMS p mais de um contacto, se for SMS n√£o aceita. Pra quem vive num pa√≠s de pouco crescimento tecnol√≥gico √© um desperd√≠cio. 	 n_util 
N√£o define o sim para envio de sms, mesmo que vc ja tenha definido. Toda vez que for enviar sms precisa indicar qual o sim card. N√£o envia confirma√ß√£o de leitura/recebimento de msg. Ja foi melhor. 	 n_util 
Outros Apps, como o Hangout, fazem essa fun√ß√£o de App para SMS, o uso do Android Mensagens evita misturar, e confundir, as mensagens de texto dos Apps com os SMS das operadoras, que ainda s√£o muito utilizados. Sem travamentos, com novos recursos. Recomendado 	 n_util 
No P20 Pro a app n√£o t√™m notifica√ß√µes. J√° inicial para as defini√ß√µes de f√°brica, j√° verifiquei todas as notifica√ß√µes e est√£o todas ativas. N√£o vibra, n√£o t√™m sinal visual e n√£o t√™m sinal sonoro. 	 n_util 
Utilizo e gosto do App e gostei do layout dele, por√©m quando envio √°udios, v√≠deos ou fotos para algu√©m pelo app, n√£o aparece para as pessoas os arquivos, e nem quando me enviam. 	 n_util 
O visual melhorou bastante. Mas ainda assim deveria continuar a trabalhar para voltar a ser uma ferramenta de mensagem utilizado por todos e n√£o apenas para receber c√≥digos de verifica√ß√£o e propagandas 	 util 
Ele trava se estiver em uso para envio de mensagens para mais de um aparelho. E n√£o √© o teclado, porque o mesmo n√£o acontece com outros aplicativos. 	 n_util 
N√£o consigo enviar sms, pois diz que "n√£o h√° conex√£o sms". Mas o estranho √© que recebo mensagens da minha operadora e do cart√£o, mas n√£o recebo mensagens pessoais do meia contatos. 	 n_util 
Eu achando q era defeito do meu celular, mas √© esse app. Mando msg e n√£o vai, s√≥ fica " enviando" 	 n_util 
√ìTIMO! Cada Vez Melhor! Se continuar nesse n√≠vel de evolu√ß√£o, logo logo ser√° t√£o vers√°til quanto os mensageiros mais populares e a eu ver com vantagens. 	 n_util 
Est√° Totalmente Ruim Com Essa Atualiza√ß√£o, Fica Dano Erro Quando Tenta Exclui As Mensagens üò° Se Resolver Voltarei A Valiar? 	 n_util 
P√¥ meu celular acho que atualizou sozinho apagou tudo que tinha no meu celular.E agora esse app de mensagens n√£o quer abrir de forma nenhuma 	 n_util 
Tenho um G5 e n√£o recebo e nem mando mensagem em SMS, simplesmente desaparece as enviadas e as recebidas, n√£o chegam, preciso desinstalar e instalar novamente, super irritante, e continua o problema 	 n_util 
Um dos Piores app que existe! √â chato, in√∫til, cheio de ERROS, obsoleto...pergunto: pra que serve? Pra ficar mandando mensagens in√∫teis e invasivas! 	 n_util 
Replica as minhas mensagens no PC e me faz n√£o pegar no celular para checar os meus SMS durante o hor√°rio de trabalho. Super v√°lido 	 n_util 
S√≥ eu que tenho problema para enviar sms com a operadora TIM? J√° liguei para a mesma e n√£o resolveu nada, suponho que seja o app... 	 n_util 
O app √© √≥timo , achei o design incr√≠vel e inovador. Precisa apenas da op√ß√£o de pano de fundo para que o app fique com a cara que agente quiser. 	 n_util 
Esse app tem algo errado, quando arquivamos o msg , e, quando queremos desarquivar ai n√£o volta a receber as mensagem como eram antes. N√£o gostei. 	 n_util 
Em nov/2018 voltou a funcionar... Desde 14/08/2018 n√£o funcionava... Al√©m disto poderiam melhorar e dar responder msg na msg, como o ZAP faz. 	 n_util 
Depois da √∫ltima atualiza√ß√£o ele n√£o mostra relat√≥rio de entrega. Manda a msg tr√™s quatro vezes. Vamos melhorar por favor. 	 n_util 
Eu gosto bastante do app, precisaria aprender mais sobre o funcionamento do aplicativo para poder usufruir de todos as suas fun√ß√µes 	 n_util 
O modo escuro foi uma √≥tima adi√ß√£o, mas poderia ter um modo preto para dispositivos amoled. Fora isso, cumpre o que promete. 	 n_util 
Estou com problema ele n√£o est√° funcionando ND n√£o envia mensagem nenhuma e nem recebe celular novo Motorola One e n√£o est√° funcionando o aplicativo de voc√™s. 	 n_util 
Aplicativo muito bom com a nova atualiza√ß√£o muitos recursos e melhor desempenho Por√©m deixa a desejar que alguns recursos tem que ser usado pela pr√≥pria operadora 	 n_util 
S√≥ n√£o sei 5 estrelas porque podia ter a op√ß√£o de criar um grupo pra conversar todo mundo junto igual no WhatsApp. 	 util 
√â √≥timo, mas, seria mais interessante se a gente podesse selecionar v√°rias mensagens pra apagar, ao inv√©s de faz√™-lo unitariamente. 	 util 
Por enquanto n√£o tenho muito a falar, mais uma coisa n√£o ficou legal demora para enviar mensagem pede para fechar o app 	 n_util 
O app est√° melhorando, por√©m n√£o chega a um n√≠vel de WhatsApp. Mas para uma simples mensagem (SMS) est√° bom. 	 n_util 
E um app muito bom por√©m da muitos problemas, as vezes os SMS param de chegar e isso √© horrivel ! 	 n_util 
N√£o estou conseguindo receber as msj de texto ? J√° revirei as configura√ß√µes mais mais sem sucesso por esto s√≥ 2 extela 	 util 
Excelente App. Poderia disponibilizar o atraso no envio de 3, 5 ou 10 segundos, para casos de necessidade de edi√ß√£o e corre√ß√£o. Obrigado. 	 util 
S√≥ falta o recurso de √°udio e fotos sem cobrar mms e vamos abolir o Whatsapp. Amo sms 	 n_util 
Muito bom app √≥timo de usar e manusear, por√©m falta recurso pra selecionar msg para deletar. 	 n_util 
F√°cil e pr√°tico, s√≥ n√£o usamos tanto quanto anos atr√°s, mas uma boa ferramenta. 	 n_util 
Continua sem ter a op√ß√£o para por cores nos bal√µes de conversa, o que era muito melhor... Voltem a por essa op√ß√£o sff... 	 n_util 
gostei e muitooh bom tem gente q reclama e fala pros outros n baixar se vc n gostou deixe os outros esperimentar tbm. a opini√£o e dele ou dela cara fica na sua 	 util 
Muito lento. Ao abrir o aplicativo e tentar enviar mensagens √© necess√°rio aguardar alguns segundos ara faz√™-lo. 	 util 
Uma pena que as operadoras administrem t√£o mal o sistema e que fa√ßam uso t√£o ruim dele. 	 n_util 
S√≥ serve pra receber mensagens da operadora, dizendo pra eu colocar cr√©dito, nem sei pra que tenho instalado 	 n_util 
√â um aplicativo que tem facilitado bastante a minha vida e minha rotina din√¢mica. Parab√©ns e obrigado! 	 n_util 
acabei de enviar SMS (mensagem de texto simples) para v√°rios contatos e assumiu e enviou como MMS. obviamente o envio deste tipo tem um custo associado. n√£o estou para quando tenho que enviar para v√°rios estar sempre a suportar custo. nas vers√µes anteriores funcionava muito bem. agora?????? 	 util 
Gostei bastante, mais precisa melhorar bastante, como, no Emoji recebidos. N√£o tem como ver o Emoji que a pessoa te enviou, ele sempre aparece como se a pessoa estivesse mandado um sinal (?) De interroga√ß√£o. Por favor consertem isso. 	 util 
Estava a gostar imenso da aplica√ß√£o s√≥ q apanhei com um erro nos "√ß" por favor corrijam isto 	 n_util 
Eu tenho um Moto G5s Plus e j√° faz duas semana que n√£o consigo enviar SMS, j√° reinicie o aplicativo e atualizei e mesmo assim n√£o consigo. Me ajudem pfvor ! 	 util 
- Falta modo noturno autom√°tico consoante hora (hora in√≠cio/hora fim) - Falta a op√ß√£o de sele√ß√£o m√∫ltipla de mensagens para apagar - O servi√ßo de chat tem muito para melhorar, nem sempre funciona e nem sempre as mensagens s√£o enviadas/recebidas 	 util 
App version from 19/10 does not work (using OP2 with Oreo 8.1). When I try to open it, the screen just starts flickering, it is impossible to access any message and very difficult to close the app. I had to revert it to the previous version and disable automatic updates. 	 util 
Interface atraente, serve bem ao prop√≥sito de receber mensagens SMS. L√≥gico que pode melhorar para se tornar um aplicativo de primeira necessidade, tal como se tornaram outros mensageiros eletr√¥nicos. 	 util 
No geral √© boa, mas podiam adicionar a op√ß√£o "deslizar para apagar" 	 n_util 
Meu app n√£o funciona, n√£o consigo enviar e nem receber SMS. O sistema do celular e o app (MENSAGENS) est√£o atualizados e configurados corretamente, mas n√£o consigo utilizar.preciso de uma solu√ß√£o 	 util 
Espere e ver√°. Novo concorrente do Imessage da Apple. Ansioso pelo RCA! üôåüèΩ 	 n_util 
Muito bom aplicativo do Android ,muito pr√°tico de usar e super decoradinho Adooorei ‚ù§Ô∏è 	 util 
Gosto muito desse app simples de usar , nunca foi preciso usar outro cumpre muito bem ao que foi destinado üòä 	 util 
Eu amei esse app depois de atualizado fkou super melhor atualizem fko √≥timoüòçüòòüëèüëèüëè 	 util 
Ao q parece s√≥ serve pra substutuir msm o app de mensagens padr√£o do aparelho. Ou talvez a outra pessoa tbm tenha q possui o app pra funcionar. 	 util 
Ele n√£o envia mensagens muito exten√ßas e quando envia demora muito Outro problema √© que certas mensagem demoram a ser enviadas e quando tento excluir algumas mensagens ele trava 	 util 
ai n√£o d√° passaram do limite,se queriam os numeros de todos e tentar ser whats app,tenham vergonha na cara em obrigar a usar......p√©ssimo....quando eu estiver na europa ,processo vcs..... 	 util 
J√° que eu acho o WhatsApp muito chatoooo!! Este app Atende as minhas necessidades... gostei muito! 	 n_util 
√â bom. Apenas me incomoda alguns acentos n√£o entrarem quando digitamos. 	 n_util 
Antes da atualiza√ß√£o, a apar√™ncia da aplica√ß√£o era muito mais apelativa ao olhar. Dava para mudar as cores das conversas, diferenciando cada contacto por cores. Al√©m de que tudo est√° mais formal, nomeadamente, os s√≠mbolos nos contactos, o que n√£o me agrada muito e nem posso mudar. Gosto de poder edi‚Ä¶ resenha completa 	 util 
Algu√©m me consegue explicar o que √© o aviso (sem liga√ß√£o SMS) no topo de uma conversa ????? Acho que me aparece desde a √∫ltima atualiza√ß√£o do android mas cont√≠nuo a conseguir enviar SMS. 	 util 
Gostei da nova atualizado, mais intuitiva, simplificada e atrativa. Parab√©ns para a equipe e desenvolvedores. Eu recomendo !! 	 util 
Desculpa mais este app √© ruim n√£o aceita acentos e demais caracteres, e demora muito pra enviar mensagem, e n√£o corrige erros ortogr√°fico , eu n√£o recomendo!! 	 util 
Funciona bem, por√©m hoje usamos mais WhatsApp pois ao utilizar um wi-fi facilita muito na hora de enviar uma mensagem. 	 util 
Desde a √∫ltima atualiza√ß√£o as vezes da erro e qiando n√£o demora pra enviar as mensagens.E n√£o aparece mais aa notifica√ß√µes de entrega ao destinat√°rio.Concertem isso ai por favor!!! 	 util 
Eu amo esse app mais depois da atualiza√ß√£o de hoje ele come√ßou a "bugar" muuuito na verdade ele n√£o est√° nem abrindo ! 	 util 
O n√∫mero de mensagens n√£o lidas dando erro fica aparecendo mesmo depois de lidas!!!! Verificar esse bug 	 util 
o app √© bom, porem deveria ter a op√ß√£o de aumentar o campo de escrever sms, poderiam colocar a op√ß√£o de envio programado de sms, corrijam isso por favor! 	 util 
Esse app n√£o deveria ter 90 MB nem √© l√° essas coisas. A Motorola deveria voltar como seus apps de SMS. 	 util 
App √≥timo, supre todas as necessidades b√°sicas, as vezes da umas bugadas e as msg n√£o s√£o enviadas, mas fora isso tudo ok. 	 util 
P√©ssimo. H√° um m√™s vem dando erro direto eu envio feedback e nenhuma resposta. Pior que n√£o consigo desistala-lo. 	 util 
Bavaahia-((https://portaldeplanos.com.br/credito-especial-claro/ Cr√©dito Especial Claro: Como pedir cr√©dito emprestado da Claro https://tecnoblog.net/121386/publicidade-sms-anatel/ Operadoras desobedecem Anatel e continuam enviando spam ... Wh√°tsapp-(55)77988633745 	 util 
Ta muito pesado pra enviar mensagem fica um temp√£o enviando e da muita falha.. 	 util 
App t√° um lixo,n√£o est√° fazendo as fun√ß√µes que antes eram poss√≠veis, travando e com muitos erros, n√£o apaga mensagem velhas, est√° sem funcionalidades 	 util 
Este app n√£o funciona para o envio de mensagens SMS para n√∫meros que possuem 5 d√≠gitos, como exemplo n√∫mero utilizados pelos bancos. Como da defesa social. Quando fa√ßo o envio da mensagem SMS, n√£o sei se √© o app ou √© falha deste sistema Android, ele simplesmente fecha o app de mensagens e reinicia o‚Ä¶ resenha completa 	 util 
Um pouco complicado de lidar, as vezes esque√ßo a senha e n√£o tem como conseguir liberar pela impress√£o 	 util 
Devia melhor Por vez eu n√£o consigo encontrar SMS que envia 	 util 
Depois da √∫ltima atualiza√ß√£o, ele come√ßou a n√£o manda as mensagens e sempre disse que esta sem conex√£o a rede. 	 util 
Antes de eu atualizar ficou dando erro,dizendo que o aplicativo n√£o t√° respondendo arrumem isso a√≠. 	 util 
Melhor app de SMS de toda a Google Play Store! 	 n_util 
√â Excelente, √© Claro que como todo e qualquer aplicativo, tende a melhorar ainda mais, mas no momento est√° satisfat√≥rio... Parab√©ns aos desenvolvedores 	 util 
A vista da aplica√ß√£o √© p√©ssima e desatualizada. N√£o tem estilo nem beleza. Nem parece que estou a usar um octacore 	 util 
N√£o se parece em nada com as fotos publicadas aqui na Google Play... parece mais uma vers√£o antiga do App... e as fotos mostram uma vers√£o mais recente e bonita. 	 util 
O aplicativo est√° demorando cerca de 5 segundos para deletar uma mensagem. 	 util 
Cara essa nova atualiza√ß√£o n√£o est√° enviando mensagens ao destino que eu quero por favor arrumem isso. 	 util 
eu achei bom, as mensagens chega de alto n√≠vel de envio 	 n_util 
As mensagens quando s√£o enviadas, no bal√£o aparecem sem a acentua√ß√£o e o "√ß" aparece "√á" em mai√∫scula... 	 util 
Fui obrigado a usar todos os meus aplicativos de mensagem em um s√≥, isso √© horr√≠vel 	 util 
Depois da √∫ltima atualiza√ß√£o o app fica fechando sozinho direto, atrapalha muito 	 util 
Ele √© bom mas infelizmente, n√£o pode apagar v√°rias mensagens ao mesmo tempo. Apagar uma de cada √© p√©ssimo. 	 util 
N√£o entrega as msg quando o destinat√°rio est√° offline. Deveria aparecer sempre a op√ß√£o. Como fa√ßo para alterar esta op√ß√£o? 	 util 
Or quando uma msg chega que t√¥ enviando outra passa um temp√£o pra enviar .... Vamos ver isso a√≠ pfvr cara 	 util 
Depois da √∫ltima atualiza√ß√£o eu n√£o consigo mais enviar mensagens, elas simplesmente n√£o chegam ao destinat√°rio. 	 util 
Falta s√≥ op√ß√£o de ver se foi visualizada a mensagem enviada 	 util 
Envio SMS Free, sem cr√©ditos com ele! 	 n_util 
Depois da √∫ltima atualiza√ß√£o...s√≥ vive dando erro nem consigo mandar SMS maia 	 util 
N√£o consigo enviar mms no grupo de contatos. Preciso que algu√©m resolva isso ou me mostre como fazer. 	 util 
Pessimo..estou com dificuldade para enviar mensagem depois q atualizou..meu celular e asus zenfone 4 selfie.. da erro direto 	 util 
Aplicativo indispens√°vel hoje em dia. Ainda n√£o explorei todas as funcionalidades dele, no entanto at√© o momento atendeu tudo que precisei. Parab√©ns aos desenvolvedores! 	 util 
Utilizo pouco, mas estou satisfeito 	 n_util 
Estou usando a poucos dias, at√© o momento estou avaliando como bom. 	 util 
Achei o app meio confuso e n√£o te da a op√ß√£o de bloquear mensagens indesejadas 	 util 
N√£o t√° chegando a notifica√ß√£o de quando a mensagem vai ser enviada,isso d√° sendo chato ent√£o pode melhorar 	 util 
Falta a op√ß√£o de configurar as op√ß√µes de deslize para deletar ou arquivar as mensagens. 	 util 
Quando estou a mandar msg leva muito tempo e ao escreve complica muito nas letras 	 util 
Conhe√ßo poucos recursos deste APP, apesar de ser bem √∫til at√© agora para SMS. 	 util 
√ìtimo, mais deveria ter por ele mesmo a fun√ß√£o de agendar mensagens 	 util 
N√£o tem como enviar mensagens digitando o n√∫mero do telefone. Voc√™ tem que possuir o n√∫mero j√° nos seus contatos. Acho isso bem ruim. 	 util 
Melhorou bastante. Vale a pena usar! üòä 	 n_util 
Gosto muito, ainda mais a vers√£o web pra PC! 	 util 
O app n√£o envia e nem recebe SMS, j√° desinstalei , atualizei e nada do mesmo funcionar 	 util 
Trava mto, as vezes os contatos somem, s√≥ fica o n√∫mero registrado, al√©m de dar erro na hora de enviar 	 util 
F√°cil de usar, preciso,oferece tudo que eu preciso.. e at√© mais! √≥timo 	 util 
Ainda n√£o utilizei por completo o aplicativo, por isso n√£o dei nota maior 	 util 
Na mudan√ßa de Android do 7.1 para o 8.1, a √∫nica coisa que n√£o gostei √© que n√£o est√° abrindo o meu armazenamento 	 util 
Melhorou, sem bugs, r√°pido e pr√°tico 	 n_util 
Muito bom para os contatos comerciais do meu interesse: drogarias, laborat√≥rios, consult√≥rios m√©dicos e odontoligicos. 	 util 
Nada a declarar 	 n_util 
Despois dessa nova atualiza√ß√£o o Messenger n√£o mostra mais quem t√° online e nem fica online como se n√£o tivesse conec√ß√£o mesmo tendo. Corrijam esse problema porque ontem antes desta atualiza√ß√£o eu tinha usado o Messenger e estava funcionando normalmente e hoje que fui usar depois da atualiza√ß√£o n√£o ‚Ä¶ resenha completa 	 n_util 
Gostaria de saber pq eu n√£o consigo entrar no messenger depois que eu terminei minha conta do face ,quando eu coloco o n√∫mero do meu celular s√≥ aparece uma msg dizendo que ocorreu um erro e n√£o tem como fazer nada ,sem dar op√ß√£o de fazer nada ... Obs: na primeira vez que me pediu o c√≥digo enviado po‚Ä¶ resenha completa 	 n_util 
Bom, mas ainda n√£o tem suporte total pra aparelhos mais novos. N√£o consigo usar gestos em tela infinita quando est√° com a janela popup aberta 	 n_util 
Em equipamentos mais simples, bloqueia com facilidade, al√©m de ser lento e consumir muita bateria! Para quando uma vers√£o Lite, √† semelhan√ßa do Facebook? Fica a dica. 	 n_util 
P√©ssimo, todos os dias mudam e todas a mudan√ßas s√£o para regresso..cada dia mais fraco, falta concorr√™ncia.. lixo de aplicativo 	 n_util 
O Messenger era pra mudar para uma vers√£o melhor em branco muito bonito .. esse tempo mudar pra branco .. depois volto pra esse azul .. eu gostei da vers√£o branco 	 n_util 
Esta horr√≠vel essa √∫ltima atualiza√ß√£o nao carrega e nao mostra quem est√° online ten que fica desistalando e instalando isso e p√©ssimo 	 n_util 
P√©ssimo. N√£o tem com limpar pesquisas, gerenciar as pessoas e contatos. Eles simplesmente ficam l√°. Incab√≠vel isto, n√£o poder gerenciar os seus contatos. 	 n_util 
Gosto da forma r√°pida que consigo me comunicar com todos que eu precisar. Receber pedido para aceitar msg tbm √© muito bacana. 	 n_util 
Gostei da √∫ltima atualiza√ß√£o, novo designer, por√©m a atualiza√ß√£o n√£o foi mantida! Revejam isso por favor!! Gostei da nova atualiza√ß√£o a antiga n√£o mim agrada mais!!! 	 n_util 
Eh bom sim, mas deveria ter o emoji da raposa que at√© agora n√£o tem. 	 n_util 
BOM , S√ì CORIGE UM ERRO DE ONLINE OU N√ÉO POR FAVOR , SE N√ÉO VOU RECLAMAR PARA TODO MUNDO DISSO E VCS NUNCA MAIS V√ÉO GANHAR DINHEIRO 	 util 
S√≥ queria que o browser n√£o me jogasse pro Google play 	 util 
Diz que tenho que atualizar o meu telem√≥vel sabendo que j√° esta atualizado para jogar jogos 	 n_util 
Estava muito boa aquela apar√™ncia nova, mas infelizmente voltaram pra antiga... 	 n_util 
Piorou c atualiza√ß√£o, ja nem consigo ver quem esta online 	 n_util 
Um visual perfeito veio a todos nos.. E no MSM momento foi tirado.. UE? 	 n_util 
So esse m√™s ja actualizei 3 vezes e ainda ta ruinüò•üò• 	 n_util 
Poderia melhorar n√£o sou especialista mas n√£o gostei muito do mensseger 	 n_util 
O messenger e bom mais fica travando muito 	 n_util 
N√£o gostei da nova vers√£o, achei feio e muito simples. 	 n_util 
Se tornou meu app de mensagens padr√£o. 	 util 
Por favor voltem a atualiza√ß√£o anterior.tava mas bonito rosa por favor 	 n_util 
N√£o est√° mostrando quem t√° online, n√£o funciona, cada vez pior üò°üò°üò° 	 n_util 
P√©ssimo n√£o consigo ver quem est√° online conserte logo isso 	 n_util 
Deveria ter a op√ß√£o de selecionar conversas para excluir de uma vez s√≥, n√£o uma por uma. 	 util 
E muito bom pra trocar indeias com os amigos 	 util 
√â muito pra covesar brincar jogar √© √≥timo 	 util 
Horrivel, n√£o consigo acessar mensagens antigas e nem mensagens arquivadas. 	 n_util 
E muito bom vcs fica falando que n√£o √© bom e a cara de vcs eu adorei e muito muito muito bom mesmo tem chamadas gratuitas tem mess 	 util 
Muito bom para me comunicar com meus amigos 	 n_util 
Ta orivel e mova atualiza√ß√£o ta orivel 	 util 
Est√° muito Rui essa nova atualiza√ß√£o ok 	 n_util 
Dis que me ama porraüòâüòÉ 	 util 
estou no face e quando clico para enviar mensagens sou direcionada para o play store ! 	 util 
N√£o aparece mais as pessoas que est√£o online.. 	 n_util 
N√£o consegui abaixar todas figurinhas 	 n_util 
Eu amei super pr√°tico 	 util 
Eu adoro esse app 	 util 
atualizem meu s4 mini n√£o est√° funcionando 	 n_util 
Muito bom.. eficaz cumpre o que promete..!!üëçüèºüëçüèºüëçüèº 	 util 
N√£o mostra o quando as pessoas est√£o ou estava online 	 n_util 
Esta aplica√ß√£o √© muito √∫til 	 n_util 
Tem que melhorar alguns ajustes 	 n_util 
Muito legal eu adorei a atualiza√ß√£o 	 n_util 
Porque voutou com o visual antigo o novo tava bem melhor 	 util 
Aplicativo for√ßa atualiza√ß√£o travando todo o meu aparelho. 	 util 
est√° bloqueado n√£o deixa conversar 	 n_util 
Um app muito bom gostei 	 n_util 
√â muito bom melhor doque o lite 	 util 
Esta muito confuso e demorado,e p√°gina + p√°gina 	 util 
N√£o tenho tudo que amo , mas amo tudo que tenho! 	 util 
Antes dava pra apaar v√°rias mensagens de uma s√≥ vez e agora n√£o ??? 	 util 
Como eu coloco aquela atualiza√ß√£o 	 n_util 
Eu acho otimo esse aplicativo 	 util 
√ä um bom aplicativo para conversas privadas 	 n_util 
Eu achei esse aplicativo bom 	 util 
T√° um pouco ruim 	 n_util 
Bom mais poderia ser melhor 	 util 
Gostei muito bom 	 n_util 
Est√° tudo p√©ssimo 	 n_util 
N√£o consigo receber mensagens do Instagram!!!! 	 util 
Um bom app ajuda bem !!!! 	 util 
Muuuuuuuuuuuuuuuuuuito bom gostei de mais 	 util 
Poderia melhorar a cara dele 	 util 
N√£o tenho nada para reclamar 	 util 
App muito bom recomendo 	 util 
E muito bom 	 n_util 
O aplicativo √© bom 	 n_util 
Muito bom 	 util 
Complica muito o messeger 	 n_util 
E o melo app 	 n_util 
√â Bom De mais j√∫nior üòÖüòÖ 	 util 
Show, nota 1000 	 util 
ele √© p√©ssimo 	 n_util 
N√£o est√° funcionando 	 util 
Vai tomar no cu 	 util 
Eu amo facebook 	 util 
Bomü§êü§ê 	 util 
Muito bom 	 n_util 
Muito bom 	 n_util 
Podia o evoluir 	 n_util 
N√£o atualiza. 	 util 
Muito bom 	 n_util 
√â legal 	 n_util 
Muito boa 	 n_util 
Excelente.... 	 n_util 
Gostei 	 util 
Achei üëç 	 n_util 
Ruim 	 util 
amei 	 util 
Show 	 util 
N√£o sei 	 n_util 
Muito bom 	 util 
Vou usar 	 util 
Bom app 	 util 
Achei bom 	 util 
muito bom 	 util 
Excelente aplicativo 	 util 
MT bom 	 util 
Gostei muito 	 util 
Muito obrigado 	 util 
Nada a declarar 	 util 
Muito bom 	 util 
Jesus Cristo 	 util 
Muito bom 	 n_util 
Gostei. üëç 	 util 
Adoreiii 	 n_util 
Oti 	 n_util 
Amei 	 n_util 
Boa 	 n_util 
Chique 	 n_util 
Bom 	 n_util 
Adorei 	 n_util 
√ìtimo 	 util 
Irado 	 util 
Firme 	 util 
Satisfeito 	 util 
Bom 	 util 
Show 	 util 
Excelente 	 util 
Obrigada 	 util 
Legaal 	 util 
Legal 	 util 
Legal 	 util 
Gostei 	 util 
Top 	 util 
O aplicativo √© √∫til, tinha gostado bastante da atualiza√ß√£o que teve recentemente, estava com uma apar√™ncia bem legal, rodava tudo bem mais fluente, por√©m voltou a mesma apar√™ncia que era antigamente, n√£o entendi, gostaria que retomassem aquela nova apar√™ncia. Essa vers√£o √© p√©ssima #novaaparenciadome‚Ä¶ resenha completa 	 n_util 
Ameii 	 n_util 
A aplica√ß√£o atualizou ficou muito mais simples. E depois voltou ao normal estava muito melhor. Podiam voltar a por como estava. 	 n_util 
Tinha atualizado e ficado com um visual muito clean, estava perfeito, por√©m retrocedeu ao atraso do velho design 	 n_util 
√â tanta atualiza√ß√£o que o meu n√£o faz mais som üò§ 	 n_util 
Falta melhora um pouco 	 util 
Trava dms nem vem falar q meu Tell √© Samsung q n √© ... Tem hora q a pessoa j√° saiu e fala q t√° on as mensagens tem hora q buga e n envia os filtro do Messenger t√° um bilh√£o de vezes mais bugado a cada atualiza√ß√£o t√° ficando mais paia smldd 	 util 
Estou apenas com certos problemas com o design da nova atualiza√ß√£o que voltou ao anterior, e estou sem id√©ias de como resolver. J√° tentei trocar de conta e limpar os dados, mas nada fez o "design clean" da nova atualiza√ß√£o se assumir. Nem as cores degrad√™ dos chats est√£o aparecendo. 	 n_util 
Boa noite . Aqui Depois da atualiza√ß√£o meu mensagem n√£o est√° funcionando . N√£o d√° pra envia mensagens . O meu e moto G5s e n√£o d√° pra manda msg pra ningu√©m s√≥ fica dando erro . J√° reiniciei ele mais t√° a mesma coisa . Arruma por favor obgd 	 n_util 
A aplicacao √© boa e eu gsto so que eu queria saber como posso apagar uma conta Eu tenho duas contas e elas tem o mesmo numero e a mesma palavra- passe eu n√£o consigo entrar naquele que eu quero Por favor ajudem-me 	 util 
Cada vez pior. Consigo ver quando os amigos est√£o online menos aqueles com quem mais falo. Esta situa√ß√£o j√° se verifica h√° mais de um ano, todos os dias colocam actualiza√ß√µes in√∫teis no app mas resolver os problemas nada. 	 n_util 
O criador desse aplicativo dever colocar a opcao apagar todos Excluir um por um fala serio viu Ajuda ae amigo ...faz uma opcao util de grande ajuda.... Ninguem merece passa o dia todo pra excluir mensagens... Nunca passou por sua mente isso ? Que dar trabalho excluir um ,por um ... 	 util 
Trava muito e a janela fecha o tempo todo sozinha. √â pesado. POR FAVOR CONSERTEM O TEMPO ONLINE. A PESSOA FAZ DUAS HORAS Q TAVA ONLINE E ELE ACUSA 1 MINUTO. N√ÉO ACUSA O TEMPO CERTO DE ONLINE. MTO CHATO ISSO. 	 n_util 
Bogus improvements. IOS design on android app is kind of a downer, induces you to share you phone contacts asking in an unclear shady way, isn't clear about who can see what contact information (its whatsapp with Facebook privacy policy, so expect you life to be their property now) 	 n_util 
N√£o consigo usar o √≠cone de bate-papo pois o messenger sempre desconecta e fica "aguardando rede" , j√° tentei v√°rios m√©todos mas sempre √© assim, at√© quando eu saio do APP mas n√£o finalizo ele. 	 util 
Por alguma raz√£o reverteram a √∫ltima atualiza√ß√£o que a interface estava bel√≠ssima! E por incr√≠vel que pare√ßa n√£o travou uma √∫nica vez desde a ent√£o atualiza√ß√£o. Agora reverteram para essa antiguidade lixosa que trava s√≥ de abrir o chat. P√âSSIMO. 	 n_util 
Gostava mais quando o messenger era inclu√≠do no facebook agora est√° muito ruim principalmente para pessoas que tem o celular com pouca mem√≥ria a√≠ deixa de us√°-lo por isso na minha opini√£o tinha que ser um APP que d√° para todas as pessoas usarem desde a mais pobre a mais rica pois n√£o √© todas as pess‚Ä¶ resenha completa 	 n_util 
Esta semana o app estava com uma interface linda demais e muito boa, sem travar, enfim estava excelentes. Ai hoje voc√™s resolvem voltar para a vers√£o antiga horrorosa que so trava dei uma estrela pq nao tem como dar 5 estrelas negativas 	 n_util 
Meu Aplicativo esta Bugado as pessoas saem do me seger e ainda fica online a 1Min. Sendo que elas j√° sa√≠ram a mais de 1h. Descobri esse bug pq uso o Lite tamb√©m! 	 util 
Na verdade, n√≥s que usamos o aplicativo Facebook fomos obrigados a baixar esse Messenger para que podemos conversar,pois antes tinha o bate-papo e eu pessoalmente achava muito mais pr√°tico. 	 util 
Pra quem tem que responder mais de 200 mensagens como eu, √© p√©ssimo ter que ficar voltando l√° pro fim das mensagens ainda n√£o respondidas, ele volta pro topo toda vez.. atrasando a vida do usu√°rio que faz neg√≥cio via aplicativo, CORRIJAM ISSO! 	 n_util 
O app era √≥timo! Eu usava todo dia, mais ai teve a nova atualiza√ß√£o e ficou horr√≠vel. N√£o dar pra ver quem ta online e as msg n√£o entrega.. Por favor arrumem o APP pra voltar ao normal 	 n_util 
√â um app que n√£o consigo nem trocar de conta, sempre da erro. A nova interface apareceu uma vez e depois voltou ao antigo. N√£o entendo como uma empresa do tamanho do Facebook n√£o consegue fazer um app funcional sem erros. 	 n_util 
Bom, por√©m as liga√ß√µes e chamadas de v√≠deo s√£o muito inst√°veis mesmo com uma rede r√°pida. E sinceramente o pior erro foi terem removido os adesivos da pusheen na √∫ltima atualiza√ß√£o, ela era a gra√ßa do aplicativo, deveriam colocar novos, e n√£o remover os poucos que existiam. 	 n_util 
Adorei a atualiza√ß√£o mas infelizmente saiu do nada. Voltou para a vers√£o anterior e n√£o aparece a op√ß√£o atualizar aqui na play Store. Gostaria que resolvessem esse problema pois amei demais a nova vers√£o mas infelizmente sumiu do nada e agora n√£o quer atualizar. J√° reiniciei o telem√≥vel, j√° desinsta‚Ä¶ resenha completa 	 n_util 
Tava muito boa a nova atualiza√ß√£o, mas retrocederam para a antiga de forma que trava muito. Est√£o de sacanagem n√©? Se seguir assim vou desinstalar esse app e n√£o vou us√°-lo. 	 n_util 
O App se tornou chato, avisa de tudo, te obriga as coisas, se add um novo amigo ele notifica, e ainda quer obrigar a vc mandar mensagem, se algu√©m fala ele te notifica se n√£o responde, te notifica novamente, Deus me livre, s√≥ tenho pq sou obrigada mesmo por trabalhar com vendas 	 n_util 
Poderia ser melhor vc enviar um mensagem passa mais de 24 horas pra pessoa receber mesmo estando olaine sir teu amigo est√° olaine n√£o aparece na mesma hora deveria te fun√ß√µes melhores 	 n_util 
Olha eu n√£o gostei do seguinte fato o App atualizou ficou lindo por√©m voltou ao normal em poucos minutos queria saber o motivo. Voltem por favor com a nova apar√™ncia essa velha j√° cansou 	 n_util 
Depois desta atualiza√ß√£o, ficou um lixo, pois n√£o d√° para ver o visto por √∫ltimo e sem contar que n√£o consegui achar o lugar de excluir as mensagens em massa, simplesmente p√©ssima esta atualiza√ß√£o! N√£o vejo nada de bom no messenger, e quero que vcs voltem para a vers√£o antiga. 	 n_util 
Seria melhor se n√£o aparecessem as mensagens quando aceita alguma amizade no Facebook. Fica acumulando muitas mensagens desnecess√°rias, atoa. E falta ter como selecionar v√°rias conversas de uma s√≥ vez para apagar. Em vez de uma por uma. Falta mais atualiza√ß√µes... 	 n_util 
o meu mensenger eu tenho muita memoria mas aparece uma barrinha laranja aguardando rede a minha internet est√° boa ta tudo bem mas arrumem pra n√£o aparecer pra mim aguardando rede que o meu wifi esta bom e a mem√≥ria tenho muita arrumem 	 n_util 
Na minha opini√£o, o facebook s√≥ tinha a ganhar em ter deixado a interface que esteve dispon√≠vel apenas por horas penso eu. Estava uma interface muito mais limpa e organizada. E se tivesse dentro de uma aplica√ß√£o, o messenger n√£o ficava lento. 	 n_util 
Um saco ter que instalar isso. Acho desnecess√°rio ter um aplicativo a mais no celular se j√° tenho o face e poderia mto bem mandar msg por l√°, aff! 	 n_util 
Atualiza e nada se modifica pelo menos em quest√£o de apar√™ncia, saiu uma recentemente mais logo em seguida retiraram,essa apar√™ncia j√° est√° um pouco enjoativa s√≥ acho que deveria mudar um pouco 	 n_util 
SOU CABRA MACHO,TRABALHADOR,NAMORADOR,TRANQUILIN E S√ì NA P√ÅZ, E DE VEZ EM QUANDO GOSTO DE TOMAR UMA SA√öDE IR√Å COM OS AMIGOS. MAS NINGU√âM √â OBRIGADO A CARREGAR A CRUZ DE NINGU√âM N√ÉO J√Å BASTA A NOSSA A GENTE S√ì AJUDA QUEM QUER SER AJUDADO POR SEN√ÉO S√ì A POLICIA COM OS TAL√ÉO NA BOCA PRA CARA FORA E NA ‚Ä¶ resenha completa 	 util 
Mano, eu s√≥ quero saber onde d√° pra ver a m√≠dia da gente com outra pessoa. Essa fun√ß√£o foi retirada? Se sim, n√£o gostei nem um pouco disso. 	 util 
Nao da pra enviar contato GENTE TA FALTANDO A OP√á√ÉO DE APAGAR TODAS AS CONVERSAS AO MESMO TEMPO QUE DROGA PQ VCS NAO RESOLVEM ISSO ? 	 n_util 
Atualizou para a nova vers√£o do nada voltou √† antiga deixou de dar para ver quem est√° online e est√° sempre a falhar a rede apenas no messenger o que se passa? Podem dar uma explica√ß√£o? Ajuda por favorüò† 	 n_util 
A nova atualiza√ß√£o √© muito ruim, eu e outros conhecidos odiamos ela A vers√£o antiga era muito melhor, acabou com toda a "gra√ßa" do aplicativo, n√£o recomendo pra ningu√©m.. Parece q atualizou pra piorar.. Vers√£o nova muito ruim, 1 estrela dessa vez, p√©ssima vers√£o. 	 n_util 
Como j√° falaram algumas vezes, a volta para a antiga vers√£o n√£o foi boa. E agora SEMPRE d√° erro. As imagens recebidas n√£o s√£o mais carregadas, assim como as conversas, que t√™m partes "perdidas". 	 n_util 
Depois da ultima atualiza√ß√£o o messenger esta constantemente a fechar, o que incomoda muito, pois durante chamadas com amigos do nada o messenger fecha e tenho de ligar novamente, isto varias vezes seguidas 	 util 
Mais outro app in√∫til do Facebook (o que ele faz, poderia muito bem ser feito atrav√©s da web), que √© obrigat√≥rio para quem quer enviar mensagens atrav√©s da plataforma. 	 n_util 
It's soo much better now but i still dont like the location of the games, imoji, gif and etc.... Those circles on the bottom... They are anoying on that location. Everything else seems good 	 n_util 
Depois da √∫ltima atualiza√ß√£o, ficou com muitos bugs, como podem ver nos coment√°rios, muito usu√°rios est√£o a reclamar disso, as vezes mostra quando o usu√°rio est√° online, e as vezes n√£o, corrigam isso e darei 5 estrelas... 	 util 
Eu estou FELIZ por estar aqui em casa agora s√≥ falta voc√™ n√£o se preocupe irei para encontro da minha felicidade em Currais Novos RN. 	 n_util 
Ajeita esse aplicativo, sempre q eu mando SMS, da problema, tipo voc√™ n pode m√°is enviar SMS..pra essa pessoa..faz qualquer coisa pra arrumar isso... 	 util 
J√° que voc√™s zelam tanto pela privacidade dos clientes, voc√™s deveriam por a op√ß√£o de "sair do Messenger",pq as vezes n√£o estamos usando do nosso telefone √© a conta acaba ficando aberta s muito exposta,j√° tive problema por causa disso e acredito que n√£o devo ter sido o √∫nico. O aplicativo tamb√©m bug‚Ä¶ resenha completa 	 n_util 
Depois desse √∫ltima atualiza√ß√£o tiraram a fun√ß√£o de criar atalho de conversas, estou bem decepcionada, fora as milhares de vezes que o App buga ou trava! 	 util 
O ruim √© que tem umas mensagens que agente envia para outra pessoa e s√≥ chega nela um dia depois, queria que vcs resolvessem esse pequeno problema!! 	 util 
Tanta atualiza√ßao e nada mudaüò° No meio da semana o visual mudou e estava PERFEITO! Mas de repente voltou ao normal, a mesma velha apar√™ncia cansada e surrada de sempre. Affffüò°üò°üò° 	 n_util 
A atualiza√ß√£o dessa semana estava bem melhor, estava com apar√™ncia limpa e rodava mais r√°pido sem travar, por√©m voltaram com a vers√£o antiga. NOVA VERS√ÉO J√Å 	 n_util 
O app atualizou ficou com uma apar√™ncia muito mais clean, por√©m j√° voltou ao normal!! Gostaria que eu ao haver uma atualiza√ß√£o a mesma fosse mantida 	 n_util 
Gostaria de enviar um √°udio para um contato no whatsap mas o menser so me oferece compartinha com meus contatos do menser. Poderia deixar compartilhar com todos app n√© 	 util 
Eu tinha gostado muito da apar√™ncia que ele estava, mas voltou ao normal. Por favor, deixem pelo menos uma configura√ß√£o nele para quem quiser a outra apar√™ncia. 	 n_util 
Really bad optimised, it easly crashes in few minutes and closes automatically. Sometimes you want to quote a message to another person and it only shows group chats. It changes your state to online everytime you open it if you are connected from phone and pc at the same time. 	 n_util 
O App nao notifica as msgs quem chegam. At√© mesmo se eu abrir, leva alguns minutos pra cair a msg. Eu sempre mantenho o App atualizado, melhorem isso por favor! 	 n_util 
Boa tarde, A minha festa de anivers√°rio ser√° esta sexta-feira, dia 31 Agosto, no cinema do Madeira Shopping √°s 14:50.O filme ser√°:" Hotel Transilvania 3". Obrigado por vires abra√ßo Mateus. 	 n_util 
Comecei a usar o Skype assim que saiu, acostumei com ele e agora ficou ainda melhor. Para mim esse √© o melhor aplicativo de VOIP . 	 n_util 
Otimo. Nunca me deixou na mao. Quando preciso. Ha muitos anos utilizo para trabalho e sempre tenho minhas reunioes garantidas. Parabens 	 n_util 
Sempre que reinicia o celular tem que relogar na conta de novo 	 n_util 
ficaria melhor se vcs entrasse em contato com M√°rioLuizRodriguesBarradatijuca RiodeJaneiro pedisse pra ele entrar em contatocomigo 	 util 
P√©ssimo tem capacidade de ser melhor. Deve ser melhorado em todos aspectos 	 util 
Podia fica uma pouco melhor, n√£o consigo fazer liga√ß√µes 	 util 
Muito bomm 	 util 
Ocupa muito espa√ßo 	 util 
Quero o anterior..... 	 util 
Otimo 	 util 
√ìtimo 	 util 
Pesimo 	 util 
show 	 util 
Otimo 	 util 
O App tem ocorrido problemas no envio mensagens ao enviar fica enviando sem chegar destinat√°rio , com isso necess√°rio desinstalar e instalar para voltar normal ,um transtorno pois tem sido frequente 	 util 
Old version was really better!! What are you doing Microsoft?? I decided to deactivate this app after the last update... design, delay in response time, message not delivered, etc. 	 util 
A vers√µes mais novas est√£o bem melhores, melhor estabilidade e funcionalidades. A quest√£o da conectividade ainda n√£o √© boa. Precisa de uma conex√£o muito boa e ativa pra poder receber e enviar mensagens 	 n_util 
Perfeito, para aqueles que tem dificuldade de abrir o app Skype, que tal baixar o Skype Lite? (Fa√ßa a sugest√£o no Hub de feedback do Win 10 ou no Microsoft Comunity) 	 n_util 
Esta √∫ltima atualiza√ß√£o est√° com um bug no qual as mensagens n√£o s√£o enviadas mesmo com sinal de Internet normal. √â preciso fechar o aplicativo e abrir novamente para que as mensagens sejam enviadas. 	 n_util 
Gostei da nova interface! Ficou mais limpa e mais pr√°tico de usar. Parab√©ns, Microsoft! Pra chamadas de v√≠deo ainda √© o melhor. 	 n_util 
Primeira vez que usei e fiquei satisfeito com o aplicativo na video chamada. Por√©m depende de uma conex√£o boa de internet. 	 util 
Cada vez pior, bloqueia, fica lenta... Num telem√≥vel novo P20 lite. Como pode isso acontecer? 	 n_util 
Eu acho o skype muito bom mais do falta mesmo poder aumentar ou diminuir a voz de cada pessoa na call √© no celular tirar aquela aba que fica na ta atrapalhando as vezes pq as vezes a pessoa quer mecher no celular e n√£o consegue 	 util 
O aplicativo √© muito est√°vel e a qualidade da chamada √© muito boa, infelizmente ele n√£o tem me notificado sobre chamadas de v√≠deo ou mensagens a menos que eu abra o aplicativo, o que podem se passar dias. 	 util 
Aplica√ß√£o muito pr√°tica para efetuar chamadas do estrangeiro a baixo custo e com qualidade. 	 util 
Vcs podiam melhorar um pouco o layout, continua confuso para muitos usuarios, tanto no Android/IOS quanto na versao de desktop, fora isso, tudo no skype ja esta bom. Obrigado pela Atencao. 	 util 
Microsoft nao vale nada...3a vez nao poco entrar na minha conta 	 util 
O app por si √© bom mais n √© o melhor app de comunica√ß√£o o app so tem um erro q me incomodou foi q n da pra compartilhar a tela q nem o de pc ; / 	 util 
Trava muito, mesmo com a velocidade da internet boa! Envia msgs para algum e para outros n√£o 	 util 
S√≥ envia mensagens quando quer 	 util 
est√° muito ruim travando , n√£o chega msg notifica√ß√£o n√£o faz barulho , eu clico e demora pra chegar a mensagem , chamada de v√≠deo trava demais . 	 util 
Horr√≠vel! Instabilidade e inconsist√™ncia s√£o as caracter√≠sticas primordiais deste app. A era de grandeza, onde existia qualidade, foi embora pra sempre. Realmente descepcionado. 	 util 
√â complicado atualizar contatos tanto pra acrecentar contatos novo so dei 3 estrelas por esse motivo. Agora qualidade de ligacao √© otimo 	 util 
Serio do com Raiva eu entro no App e da um problema Chato que fica falando que deu um problema,para entra no site n√£o sei mas o que fazer üò°üò¢ ... 	 util 
Esqueci minha senha √© n√£o consigo fazer senha nova de jeito nenhum! Perdi todos meus contatos!! Se algu√©m puder me ajudar,agrade√ßo! 	 util 
Pago assinatura, mas n√£o consigo realizar chamadas e n√£o consigo encontrar um suporte humano. J√° tentei tudo e todos os recursos dispon√≠veis 	 util 
Muito bom. N√£o deve nada ao WhatsApp. Na minha opini√£o √© at√© superior. As chamadas de √°udio e v√≠deo s√£o bem melhores 	 util 
O Skype n est√° abrindo minha conta e eu n consigo criar uma nova conta ou seja n√£o consigo usar o skype 	 util 
Baixei agora vou us√°-lo amanh√£, e volto para dar mais opini√µes, a principio parece ser √∫ltil 	 util 
Muito √≥timo! Uma pena que no Brasil n√£o se use como se deve! 	 util 
Usem porque √© excelente e de gra√ßa! 	 util 
Skype √© skype, pra mim um dos melhores apps de mensagem. 	 n_util 
Muito bom poder falar com algu√©m que est√° longe e n√£o pagar caro por isso.üëç 	 util 
Foi a 1a vez que utilizei o App e realmente me surpreedeu. Gostei bastante! 	 util 
Legal mas quero saber como usa d√° pra ligar pro bom dia e dia n√© ? 	 util 
Adorei quando convers√£o a ver vidios 	 util 
N√£o √© oq pq vc pensa ao ver os prints desse aplicativo, acredite. 	 util 
As mensagens simplesmente param de ir do nada... Muito inst√°vel, al√©m de pesado 	 util 
Porqu√™ tudo o que a Microsoft compra piora? Cada vez pior 	 util 
N√ÉO GOSTEI PQ MINHA CONTA SAI DIRETO 	 util 
Vai pro discord 	 util 
J√° passou da hora de ter suporte nativo a telas 18:9. 	 util 
Uso muito pouco, mas funciona bem quando preciso. 	 util 
As chamadas s√£o boas 	 util 
Excelente app para chamadas de v√≠deo com compartilhamento de telas 	 util 
E melhor do q discord eu ameiiiiiiiiiiiiiii 	 util 
Muito pesado, extremamente bugado, muito inferior ao discord 	 util 
Estou gostando muito!! O App me atende muito bem!! 	 util 
melhor que o whatsapp para fazer chamadas por v√≠deo. 	 util 
√ìtimo App para se conectar para atendimentos ok line... 	 util 
Uso pouco mas √© bom e √∫til 	 util 
O app est√° muito lento 	 util 
Experi√™ncia √≥tima fazendo uso do Skype. 	 util 
Nao consigo entrar em meu app 	 util 
Muito eficiente ao que se prop√µe. 	 util 
uso muito para trabalhar e funciona muito bem 	 util 
Skype encurta dist√¢ncias, muito √∫til. 	 util 
At√© ver. Funciona como devia 	 util 
Trava demais, app mt pesado 	 util 
Estou instalando. Vou ver se consigo. 	 util 
√ìtimo para chamadas de v√≠deo! 	 util 
Se eu pudesse daria 4,5 estrelas. üåü 	 util 
As vezes da uns probleminhas.... tem vida pr√≥pria... mas est√£o melhorando... 	 util 
Rapido, eficiente, boa imagem e som 	 util 
Bem legal. Funciona bem 	 util 
Para m√≠ est√° perfecto 	 util 
Que top Esse app 	 util 
O melhor para chamadas em v√≠deos 	 util 
Eu amoooooo esse app 	 util 
Pior app que ja usei 	 util 
Melhorar como falar pelo celular 	 util 
√ìtimo para realizar chamadas internacionais 	 util 
O Skype √© perfeito maravilhoso 	 util 
Muito bom!!! 	 util 
N√£o tou conseguindo entra no aplicativo?? 	 util 
O melhor! 	 util 
Muito bom üòâ!!! 	 util 
App, Excelente! 	 util 
Pretty nice conection . 	 util 
Hoje est√° excelente. 	 util 
Muito bom!! 	 util 
O app n√£o notifica mensagens recebidas. üò°üò°üò°üò° 	 util 
Muito bom!! 	 util 
Colocar chamada gratis 	 util 
A melhor live 	 util 
Estou avisando com confian√ßa 	 util 
Achei um pouquinho bom 	 util 
Mt boa as chamadas 	 util 
App muito bom 	 util 
Eu amo o Skype 	 util 
eu recomendo que baixem 	 util 
Ruim ruim mesmo 	 util 
Boa conex√£o de v√≠deo 	 util 
Bom para comunicar com v√≠deo 	 util 
Eu tenho probleminha 	 util 
Pior aplicativo de chamadas 	 util 
Tudo muito bom 	 util 
Bom! 	 util 
Excelente aplicativo. 	 util 
Muito bom . 	 util 
√ìtimo! 	 util 
Muito bom. 	 util 
Muito bom. 	 util 
Precisa melhorar 	 util 
Excelente qualidade 	 util 
Bom de mais 	 util 
√â bom 	 util 
Muito bom 	 util 
Very good 	 util 
Muito bom 	 util 
√ìtimo servi√ßo 	 util 
T√° suave 	 util 
Muito bom 	 util 
Muito bom 	 util 
Muito bom 	 util 
Muito bom 	 util 
Muito bom 	 util 
Funciona bem 	 util 
Legal 	 util 
Pedro 	 util 
Gosto 	 util 
Bom 	 util 
Lida 	 util 
Top 	 util 
Indispens√°vel 	 util 
Too 	 util 
Bom 	 util 
Legal 	 util 
Am√©i 	 util 
Odeio 	 util 
√ìtimo 	 util 
Bommmmm 	 util 
Horrivel 	 util 
FODA 	 util 
Bom 	 util 
√ìtimo 	 util 
Humanismo 	 util 
√ìtimo 	 util 
√ìtimo 	 util 
Bom 	 util 
Legalzin 	 util 
Bom 	 util 
Excelente 	 util 
Impec√°vel 	 util 
Otimo 	 util 
Excelente 	 util 
Sensacional 	 util 
√ìtimo 	 util 
Amei 	 util 
Pastel 	 util 
√ìtimo 	 util 
Gosto 	 util 
√ìtimo 	 util 
Otimo 	 util 
skype melhorou so no interface dele, mais nao consigo excluir algns contatos, que tem no skype mesmo algun que nem conheco fica bloqueado. eu quero excluir nao consigo, e fiou muito pesado para abrir, e alem d mais penso eu que whasspat ganhou mais mais espaco na categoria de melhor aplicativo de ch‚Ä¶ resenha completa 	 n_util 
A cada atualiza√ß√£o esse aplicativo fica pior... E √© S√ì COM ELE, que tenho problemas. Desde que atualizou ele da uns bugs que do nada para de enviar a mensagem... Fica carregando um s√©culo e nunca envia eu tenho sempre que sair e voltar ou em piores casos reiniciar o celular. RID√çCULO. consertem isso 	 n_util 
Est√° pesado demais para um aplicativo de chat, existe um delay na digita√ß√£o de texto que incomoda, a vers√£o lite n√£o tem esse problema por√©m falta recursos que tem nessa vers√£o. Otimizem esse app. 	 n_util 
Quase perfeito o app! Em quase todos aspectos muito melhor que o WhatsApp!! E satisfeito, pois, percebemos que os desenvolvedores aceitam opini√£o dos usu√°rios, isso muito bom mesmo!! E Precisa melhorar a quest√£o de envio de mensagens por audio(whatsapp ainda melhor neste ponto, mas somente nisso!)..‚Ä¶ resenha completa 	 n_util 
Eu choro de saudade de antigamente quando o Skype estava em alta a unica forma de conversas entre eu e meus amigos era o Skype hoje em dia fiquei sozinho 	 n_util 
Depois da atualiza√ß√£o de ontem, o App ficou estranho, nem as notifica√ß√£o aparecem mais na barra de ferramentas, tenho que acessar o aplicativo constante para verificar se tenho alguma nova conversa. 	 n_util 
Eu gosto do app e A uns 2 anos eu o utilizava muito mas n√£o tinha a conta do Skype e era conectado com o Facebook quando baixei o app mas eu perdi documentos importantes pq estavam na minha conta do Facebook 	 n_util 
Bem lento e trava muito. Muito mais pesado do que a maioria dos aplicativos de mensagens instant√¢neas. Prefiro WhatsApp ou Instagram (que √© uma rede social de fotos...) do que ele. Infelizmente... Eu usava muito o Skype, agora s√≥ uso por necessidade, mas seria bom se fizessem uma atualiza√ß√£o mais le‚Ä¶ resenha completa 	 n_util 
Nas √∫ltimas atualiza√ß√µes as notifica√ß√µes n√£o tem aparecido na moto tela do meu moto g3, al√©m disso ele deixa de notificar na barra de notifica√ß√£o algumas mensagens que recebo. O app est√° lento demais, o que √© inadequado pra um aplicativo de troca de mensagens. Algumas vezes em que estou invis√≠vel ou‚Ä¶ resenha completa 	 util 
N√£o consigo abrir o app, o incone n√£o aparece no meu aparelho, j√° inatalei diversas vezes e n√£o aparece, as pessoas mandam mensagens e n√£o sou notificada, √© como se n√£o tivesse o aplicativo no meu aparelho. 	 util 
Poderia ter uma apar√™ncia melhor. N√£o √© pratico quando se precisa discar e cola um numero n√£o se consegue colocar prefixo. 	 n_util 
Melhorou muito! Mas ainda falta op√ß√£o para limpar o hist√≥rico ao inv√©s de ir excluindo uma conversa por vez 	 n_util 
√ìtimo,adorei eu acho que seria legal fazer um grupo aonde pessoas dentro dele lig√£o uma para as outras ao mesmo tempo do limite de 7 ou 6 pessoas 	 util 
N√£o consigo criar minha conta!!! Criei mais duas contas e toda vez que entro em alguma delas diz que o Skype erro e pede pra abrir de novo!!! 	 util 
Ativei o pacote de liga√ß√£o mensal √© nem liguei √© j√° est√° gastando meus minutos üòíüòí pode me dizer por qual motivo? 	 util 
Ap√≥s o erro de atualiza√ß√£o onde minha vers√£o normal virou o Lite agora esta normal com todas as funionalidades da vers√£o full. 	 n_util 
Aplicativo incr√≠vel que tornou poss√≠vel as minhas mais importantes conquistas e aprendizados! Imensamente grata por essa ferramenta genial! 	 util 
Esse App ainda tem muito em que melhorar. Por exemplo...Ter mais filtros, e mais op√ß√µes de edi√ß√£o de foto. 	 n_util 
E √≥timo por√©m tem emojis estranho kkk mas adorei parab√©ns 	 n_util 
√önica coisa de bom, some com as fotos do Cel kkkkkk 	 n_util 
Porqu√™ que tiraram a m√∫sica de fundo nos Snaps?? 	 util 
N√£o gostei ,demora para come√ßar a usar ,e isso √© muito chato 	 n_util 
Eu recomendo at√© minha v√≥ gosta deste app 	 util 
Quero de ficar mais bonito 	 util 
Bem legal da pra usar 	 util 
Bom 	 n_util 
Good üòé 	 util 
Odiei 	 n_util 
Odiei 	 util 
Pessimo 	 util 
Que tipo de homem que se sente menos homem pq o efeito de cachorro ta com as bochechas rosas?se seus homens se sentem com a masculinidade ferida por conta de um filtro, duvide da masculinidade dele...beijoss e pra mim ta √≥timo‚ù§ 	 n_util 
O app √© legal, mas n√£o estou conseguindo gravar v√≠deos com mais de 10 segundos. √â alguma fun√ß√£o que preciso habilitar? A internet e o Suporte do Snapchat pelo site diz que √© s√≥ eu manter o dedo pressionando o bot√£o de gravar e os Multisnaps ser√£o autom√°ticos, mas isso n√£o est√° acontecendo. 	 n_util 
No meu ver o App √© excelente,ele s√≥ n√£o √© bom para quem n√£o sabe usar o mesmo,essa √© a minha opini√£o pesso simceras desculpas se a minha opini√£o n√£o tem o mesmo intu√≠do que a sua,essa √© minha opini√£o. 	 n_util 
Esse filtro de cachorro t√° rid√≠culo os garotos tbm gostam agora seis vai l√° e coloca os olhos e a bochecha rosa odieeei j√° nem tenho mais pois o cachorro era o √∫nico que eu usava 	 n_util 
No come√ßo aplicativo tava bom mas quando eu fui mexer nele ele n√£o passa nem um minuto aberto quando desce f√© ele sai sozinho 	 util 
Eu daria 5 estrelas mas dei 2 por causa do efeito do cachorrinho por que homens e etc usam esse efeito e nessa atualiza√ß√£o nova o cachorrinho tem bochechas rosas e estraga a foto... Por Favor concerte isso 	 n_util 
J√° fais um tempo que estou usando e estou amando ainda mais agora que tem mais op√ß√µes pra gente mais velha kkk tinha umas coisas que √©ra muito infantil mais agora t√° √≥timo s√≥ tem que continuar a sim 	 n_util 
Eu daria 5 estrelas mas tem poucas carinhas,e quando quero salvar as fotos salvou s√≥ uma,queria at√© colocar no meu perfil de Whatsapp mas n√£o d√°.Melhorem Por Favoooorüò´ 	 n_util 
√â bom,mais man,arruma o efeito de cachorro vey,fica com aquele bagui l√° de menina vey,homem tbm gosta daquele efeito e n seria nada legal um homem ficar com aquele efeito q vcs colocaram no efeito de cachorro vey namoral tira 	 n_util 
O App √© bom por√©m essa atualiza√ß√£o do filtro dog √© horr√≠vel. Fica identificando rosto onde n√£o tem e esses olhos √© bochechas rosas s√£o rid√≠culos 	 n_util 
Depois da atualiza√ß√£o, meu celular Note 5, fica dando superaquecimento toda vez que abro o App. Vamos corrigir isso!! 	 n_util 
Eu entro pra tirar foto mais trava e sai ai n consigo tira foto ja faz 3 semanas aaafff arrumem isso por favor 	 n_util 
Ameiii so que instalei di novo e que o n√∫mero do meu cll ta doido n√£o entra nem o whats 	 n_util 
O cachorrinho t√° horr√≠vel com aqueles olhos √± serve pra homens mas. Arrumei isso voltei pra o q era antes. 	 n_util 
Oi pq no meu snpchat n mostra nossa hist√≥ria? Algu√©m sabe me dizer 	 n_util 
Fiquei um tempo sem entrar , excluiu todas as minhas fotos que era importantes , e n√£o consigo recupera ! 	 n_util 
S√≥ √± curto aquela maquiagem no filtro do cachorrinho... Acho q deveria voltar a ser sem g√™nero! 	 n_util 
Vem atualiza√ß√£o novaaaüòç j√° cheguei no n√≠vel 200 mas n√£o tem continua√ß√£o 	 util 
√â um app muito bom,a qualidade de imagem √© boa... Mas,tem vezes que n√£o abre! 	 n_util 
O APP √© legal, mas agora colocaram limite para mandar snap para pessoas. Queria que fosse como antes quando n√£o tinha limite. 	 util 
N√£o tem do que falar mau desse app! √â muito bom! Nunca vi melhor!! 	 n_util 
√â um aplicativo muito bom, mas tem alguns bugs. 	 util 
Eu baixei o app hj e ele n√£o abre... Sempre que eu abro ele d√° erro e fecha 	 n_util 
Adorei o snap o √∫nico problema √© que ocupa muito espa√ßo 	 n_util 
tmb n gostei pq tem meninos q gostam do filtro de cachorrinho e vcs colocaram c√≠lios bochechas rosas üåπ 	 util 
Ter seguidores e poder seguir os outros que nem uma rede social 	 n_util 
N√£o gostei n√£o da pra mudar a cor das letras nas fotos no meu arrumem issoüò° 	 n_util 
Eu n√£o gosto desse App eu nem consigo entra 	 util 
Eu j√° havia sido feito o pagamento da mensalidade e da minha m√£e e filha e n√£o consegui falar contigo sobre a primeira parte do quadro que voc√™ tenha alguma d√∫vidas sobre viados m√°s not√≠cias o que no YouTube para ver se n√£o eu n√£o tenho mas vou tentar ir e o primeiro a ser pago em anexo a empresa e ‚Ä¶ resenha completa 	 n_util 
N√£o estou conseguindo gravar v√≠deos Quando eu termino o meu v√≠deo, fica tudo preto 	 util 
Depois a atualiza√ß√£o a carinha de cachorro sumiu. N√£o gostei era a √∫nica que eu gostava. üò™üò™üò™üò™ 	 n_util 
o app √© otimoo eu amei e tabem eu amo tira fotos com o snepchat mas ele trava demais! 	 util 
S√≥ precisa melhorar o √°udio porque sai muito baixo quando faz v√≠deo com filtro. Se melhorar dou 5 estrelas. 	 util 
Eu amoo esse app da ate pra fazer vinhetas 	 n_util 
Bom mais n√£o atualiza r√°pido tem uns que meus amigos tem e eu n√£o 	 util 
√ìtimo, beixei por causa da minha namorada e gostei 	 n_util 
Muito bom mais queria que podesee tira mais foto do seu pet 	 util 
App muito bom ,por√©m podia tem a op√ß√£o de enviar todos os snep de uma vez 	 util 
Este app ele √© muito legal eu gostei dele üëç 	 util 
ta identificando carinha Onde n√£o tem, arrumem! 	 util 
Eu amooo muito esse aplicativo mais demorar muito para baixar 	 util 
Nao gostei pq nao e possivel gravar videos e ne bater fotos üò§ 	 util 
Muito bom, ‚ô° minha filha Amou esse aplicativo 	 util 
Muito bom amei‚ô° 	 util 
O ruim e que v√°rias vezes o app pede pra fechar a acaba nem abrindo ... 	 util 
√â muito bom os efeitos 	 n_util 
Quando √© k chegam os jogos?? 	 util 
√â bom m√°s tranca demais quando vai recortar as fotos. 	 util 
Pode ter mais filters 	 n_util 
N√£o gostei muito e ainda fica parado travando muito ruim 	 util 
Pq os filtros de alguns celulares s√£o diferentes? 	 util 
Daria 5 mais dei 3 estrelas 	 util 
Tem q atualizar esse App pra fica melhor 	 util 
Coloquem mais carinhas e n√£o tirem as que j√° tem 	 util 
Bom demais amei‚ù§‚ù§ 	 util 
Eu amei esse aplicativo 	 n_util 
Depois da √∫ltima atualiza√ß√£o, o app n√£o funciona mais. 	 util 
Aaaaaaammmmmmmmeeeeeeeeeeiiiiiiiii Muito bom mesmo 	 util 
As vezes trava da√≠ fica ruim 	 util 
App esquenta muito o celular risco de queimar 	 util 
Da para melhorarüê§ 	 util 
Dei 4 ‚òÖ pq as vezes trava 	 util 
O app n√£o indentifica o rosto 	 util 
Parou de funcionar ja tem meses 	 util 
Mas eu amo esse aplicativo 	 util 
E bom mais trava muito 	 util 
E muito top 	 n_util 
Esse aplicativo √© maravilhoso tudo na vida 	 util 
Bom mto bom tao de parab√©ns 	 util 
EU GOSTEI MUITO MUITO MUITO DESSE APLICATIVO. üòÇüòçüòç 	 util 
muito bom ,encomendo para vc 	 util 
e bem legal , as fotos sa√µ geniais. 	 util 
Legal,bem loko impongante 	 util 
Maravilhoso appüòç 	 n_util 
APP mt bom 	 n_util 
Gostei mais s√≥ trava 	 util 
N√£o consigo abrir a aplica√ß√£o 	 util 
√â mais ou menos 	 util 
√â bem bom os filtros 	 util 
Bah o neg√≥cio √© trilegal tch√™ 	 util 
Adoro as carinhas Principalmente as de Halloween 	 util 
Melhor aplicativo üòçüòçüòç 	 util 
Ele √© muito ruim 	 util 
Eu amei 	 n_util 
Avaliar este app 	 util 
√â bom 	 n_util 
Muito divertido!! 	 util 
√ìtimo obrigada 	 n_util 
E bem bom 	 util 
I love Snapchat 	 util 
Muito ruim o app 	 util 
E muito ruim 	 util 
Estalar mais r√°pido 	 util 
N√£o consigo abrir 	 util 
Muito legal amo 	 util 
E muito bom 	 util 
Surpreendente f√°cil de usar 	 util 
Disney world 2.0 	 util 
Amei mlhr ‚ô° 	 util 
Tira a maquiagem do cachorrinho üò≠üò≠üò≠üò≠ 	 util 
Nao gostei 	 n_util 
Constantly bugging 	 util 
Bom parab√©ns 	 util 
chato de mais 	 util 
Rammmm p√° 	 util 
MT bom 	 util 
Quase legal 	 util 
√â favoravel 	 util 
√â top 	 util 
T√° lento 	 util 
Eu amei 	 util 
Ser√° que tem o venom neste aplicativo?????? 	 util 
Muito bom 	 util 
Gostei muito 	 util 
E uippppppp 	 util 
Top top 	 util 
N√£o gostei 	 util 
Trava muitooo 	 util 
Muito bom 	 util 
Muito Bom 	 util 
Esta horr√≠vel 	 n_util 
Perfeitoüíú 	 util 
Muito bom bom 	 util 
Bom bom e bom 	 util 
Ameiüòç 	 util 
√ìtimo 	 util 
Ameiüòçüòç 	 util 
Amei 	 util 
Ameiiiiiiiiiiii 	 util 
Maravilhoso 	 util 
Perfeito 	 util 
CR7 	 util 
Amei 	 util 
Espetacular 	 util 
Maneiro 	 util 
Ameiiii 	 util 
wwwwwwwwwoooooooww 	 util 
Aaaaaaaaaaa 	 util 
Legal 	 util 
Horr√≠vel 	 util 
Adorando 	 util 
Ontimo 	 util 
Amo 	 util 
Otimooo 	 util 
odiei 	 util 
Oi 	 util 
Orrivel 	 util 
Otimo 	 util 
Gosto 	 util 
Aplicativo era √≥timo mas ultimamente n√£o anda me notificando MSG e liga√ß√µes que recebo s√≥ consigo ver que me mandaram alguma MSG ou que me ligaram nele quando abro o aplicativo justamente para ver se tenho alguma notifica√ß√£o ai quando abro comessa o telefone a vibrar tocar as msgs tudo de uma vez s√≥ 	 n_util 
Eu amei o APP curti muito ele, pena q a maioria dos meus contatos n√£o tem esse APP, gostaria d d√° uma dica seria muito bom tbm q realiza-se chamada d v√≠deo (minha opini√£o) mas super recomendo ele meus parab√©ns! 	 n_util 
Depois da ultima atualiza√ß√£o parou de notificar as mensagens. Est√° bem ruim! Mesmo assim √© leve, r√°pido e divertido! Meu sonho √© substituir de vez o concorrente por esse aplicativo! Muito mais f√°cil e √∫til para o dia a dia. Salva tudo na nuvem e n√£o ocupa hd do cel com todas as mensagens. Recomendo 	 n_util 
√ìtimo app falta da; uma melhorada nas notifica√ß√µes e outro probleminha √© que quando vc entra no App n√£o da pra saber quem te mandou a mensagem pois no contanto que te mandou a mensagem n√£o tem nada que facilite a visualiza√ß√£o como no watsap que al√©m da notifica√ß√£o quando vc entra no App a tamb√©m um ‚Ä¶ resenha completa 	 n_util 
Na minha opini√£o o Telegram √© o melhor mensageiro online da Play Store, mas infelizmente ele tem apresentado problemas no recebimento de mensagens, n√£o est√° notificando! Outro ponto que pode ser melhorado √© o reprodutor de m√∫sica que poderia usar o equalizador do dispositivo para uma melhor experi√™n‚Ä¶ resenha completa 	 n_util 
QUE ESSE TELEGRAM SE TORNE DEFINITIVO O TELEGRAM X COMO VI NOT√çCIAS EM SITES ESSA SEMANA COM RECURSOS MELHORES E QUE A CHAMADA DE V√çDEO CHEGUE LOGO PARA ESSE APLICATIVO EXCELENTE 	 n_util 
O aplicativo √© muito bom, por√©m precisa de atualiza√ß√£o para concertar o bug das mensagens que n√£o chegam na hora certa. Mas ser√° que o Telegram X vai ser atualizado para o portugu√™s? E √© muito estranho que √© a terceira vez que atualiza no mesmo dia e sempre √© a mesma coisa. Agora j√° √© 4 vez que atua‚Ä¶ resenha completa 	 n_util 
Seria o melhor app de mensagem, pena que nos aparelhos da Asus ele n√£o entrega as notifica√ß√µes, o que me obriga a usar o outro app (o famoso, que eu detesto) quando preciso que a pessoa receba a comunica√ß√£o o mais r√°pido poss√≠vel. Adoraria que voc√™s resolvessem isso. 	 n_util 
Nao sei o que acontece mas recebo msg com dias de atraso e o mesmo qndo eu mando, a pessoa demora dias para receber. Chato pq indiquei para muitos amigos e vou ter q ver um outro app semelhante, pois os comunistas querem tirar o whatsapp do ar. 	 n_util 
Aplicativo muito bom, tem fun√ß√µes √≥timas como editar mensagens e ao apagar msg n√£o aparece que vc apagou, tem senha. Mas precisa de algumas melhorias como notificar na hora certa quando a mensagem chega, mostrar na barra de notifica√ß√£o quem mandou a msg quando est√° com senha ativa. 	 n_util 
Muito bom. Apenas precisam melhorar a quest√£o das notifica√ß√µes, pois √†s vezes n√£o recebo. Al√©m disso, agora est√° ficando on-line sem a pessoa estar. Esta acontecendo com muita frequ√™ncia e isso √© muito ruim. N√£o t√° aparecendo o status certo se est√° online ou offline. Isso √© muito importante que arru‚Ä¶ resenha completa 	 n_util 
Gosto muito do Telegram e o considero o melhor aplicativo de comunica√ß√£o. A minha observa√ß√£o √© a mesma que alguns usu√°rios fizeram abaixo: n√£o estou recebendo todas as notifica√ß√µes de mensagens. Tem vez que eu abro o aplicativo e s√≥ assim aparecem todas as notifica√ß√µes de uma vez. J√° olhei nas confi‚Ä¶ resenha completa 	 n_util 
Foi-se a √©poca em que o Telegram era um app √≥timo pra troca de msgs e arquivos, hoje infelizmente, as pessoas est√£o deixando de usar este app por causa da falta de investimentos e melhorias dos seus criadores. As novas msgs n√£o chegam com notifica√ß√£o, s√≥ chega se abrir o app. Uma msg que um amigo en‚Ä¶ resenha completa 	 n_util 
√ìtimo aplicativo, por√©m, tem grave problema com as notifica√ß√µes. Recebo notifica√ß√µes de mensagens muitas horas depois, isso quando recebo. A falta de notifica√ß√£o nos obriga a ficar abrindo o aplicativo o tempo todo para checar se existem novas mensagens, o que prejudica muito a comunica√ß√£o (algo que‚Ä¶ resenha completa 	 n_util 
O Melhor, mais seguro, mais fun√ß√µes. Com ele posso participar de grandes grupos, melhor para administrar grupos, mais interativo, enviar e receber filmes completos, transferir arquivos do PC para o celular e vice versa, salvar mensagem, fazer liga√ß√µes do PC para o celular e vice versa, ver v√≠deos do‚Ä¶ resenha completa 	 n_util 
App muito bom por√©m n√£o fica mais logado direto no meu celular e fechando toda hora, n√£o possui cumprimentos caminho de suporte, por isso diminui as estrelas. N√£o consigo usar o app mais no meu celular 	 n_util 
eu gosto muito mais n ta aparecendo muito as notifica√ß√µes ta ruim nisso tem q consertar e tb vcs adicionarem a chamada de video vai ficar perfeito s√≥ falta essa op√ß√£o ta melhor do q o watts 	 n_util 
Vou dar nota baixa porque da √∫ltima atualiza√ß√£o para c√°, meu telegram t√° com muito bug. Toda vez que eu entro no chat com t√° mensagens que eu j√° visualizei como n√£o visualizada. Quando tem men√ß√£o minha no grupo, eu clico no √≠cone e n√£o vai. T√° bem sofrido de usar com tanto bug. 	 n_util 
Eu adoro o telegram e uso h√° anos. Mas desde as √∫ltimas atualiza√ß√µes que deixei de receber notifica√ß√µes das mensagens ou s√≥ recebo quando entro no aplicativo e ele aparece que est√° conectando. 	 util 
Apesar de ser muito bom tenho notado que depois que mudei pro Android Oreo, as notifica√ß√µes est√£o com falhas. S√≥ vejo que tem mensagem quando abro o aplicativo, e isso √© muito chato. Seria uma boa corrigir isso. No Android marshmallow isso n√£o acontecia. 	 n_util 
Muito r√°pido, √© na velocidade da luz, e com efici√™ncia total, mas precisa urgente de separa√ß√£o por abas, tipo aba de chat, grupo, camais, bot, assim ficaria perfeito. Mas melhore o visto por √∫ltimo, nem mostra todo na tela de chat, coloca apenas visto as... √â n√£o visto por √∫ltimo... 	 util 
Simplesmente n√£o notifica, o que torna a comunica√ß√£o muito desanimadora. Ganha em todos os quesitos pra concorrencia, mas a falta de notifica√ß√£o tem um peso imenso pra que √†s vezes eu recorra ao outro mensageiro. Consertem isso, √© o b√°sico! 	 n_util 
Muuuuuitooooo bom √© um milh√£o de vezes melhor q i Zap da para voc√™ ver se a pessoa t√° tirando print n√£o demora para carregar v√≠deos fotos etc e tem o modo de conversa secreta que voc√™ coloca o tempo para a mensagem apagar muito bom mesmo 	 n_util 
O app √© muito bom... por√©m tem 2 problema graves, raramente chega √†s notifica√ß√µes, obrigando a abrir o app e muitas vezes mostra q estou on line sem q isso seja verdade. 	 n_util 
Aplicativo excelente, mas a √∫ltima atualiza√ß√£o trouxe um problema (na minha opini√£o): a aba com m√≠dias compartilhadas agora √© de rolagem, o que faz mudar se ele n√£o identificar o movimento que voc√™ fez e perder o arquivo que voc√™ est√° pesquisando. 	 n_util 
Eu gosto muito s√≥ tele mas a √∫nica reclama√ß√£o que eu tenho a fazer e sobre uns grupos que voc√™ n√£o sabe nem da o de veio com um monte de gente falando em uma idioma que voc√™ nunca viu. Corrigi isso por favor j√° to cansada de abri o tele e ter um monte de grupo que n√£o sei nem da onde veio 	 n_util 
Se coloco um arquivo para baixar e saio do app ele n√£o termina de baixar e apaga tudo q j√° foi baixado. Antes d√° √∫ltima atualiza√ß√£o tinha conseguido baixar, um v√≠deo, mas n√£o consegui abrir o arquivo e ele tamb√©m n√£o apareceu no aplicativo de m√≠dia do meu celular (Fotos) google 	 n_util 
Ele √© muito bom mesmo, agora s√≥ est√° com um probleminha que depois que o meu celular foi atualizado demora pra chegar √†s notifica√ß√µes, Voc√™ tem que este sempre olhando o aplicativo. Melhorem isso logo.. 	 n_util 
Nas √∫ltimas semanas est√° ocorrendo um problema, n√£o est√° salvando o n√∫mero, tenho que colocar ele toda vez que entro. Antes disso estava perfeito. Agora n√£o estou conseguindo nem entrar no aplicativo 	 n_util 
Muito bom mais falta muita coisinha ainda tipo vc n√£o sabe se a mesagem caiu no celular da outra pessoa so sabe quando ela ve tinha que parecido com zap eu acho.. 	 n_util 
O melhor App de tds, n√£o tem compara√ß√£o, uma pena nI ter mtos adeptos. Parab√©ns pelo simples fato de n√≥s podermos enviar m√≠dias sem limite de tamanho. 	 n_util 
Quando vai estar dispon√≠vel a op√ß√£o pra realizar chamadas em v√≠deos?? Tamb√©m poderia melhorar mais em rela√ß√£o as notifica√ß√µes e quando algu√©m liga pra voc√™, pq nem sempre aparece. Fora isso, o app √© √≥timo. 	 n_util 
Curto d+ esse app' acho melhor que o whatsapp, so e uma pena que poucas pessoas do meus contatos que usar... Msm assim n deixo de usar ele por nada‚ô° 	 n_util 
Era √≥timo, mas a partir de dois meses para c√°, n√£o est√° chegando notifica√ß√µes das pessoas que converso. Tenho que ficar entrando no App para ver se a pessoa respondeu. 	 n_util 
As vezes n√£o notifica as mensagens e chamadas.. por favor arrumem isso e se colocarem chamada de video agradeceria tbm. ai sim, o app s√©ria perfeito. ;) 	 util 
Simplesmente perfeito. Melhor e mais completo app poss√≠vel. N√£o entendo pq as pessoas ainda usam o tal led zappelin sendo que o telegram √© uma verdadeira obra prima da tecnologia. 	 n_util 
Telegram is much more powerful, fun, smart and light than WhatsApp, It keeps your files in the cloud so you can recover them everytime you want. (Telegram √© muito mais poderoso, divertido, inteligente e leve que o WhatsApp, ele tem a vantagem de manter seus arquivos na internet para que voc√™ possa r‚Ä¶ resenha completa 	 n_util 
Gostaria de pedir para que quando encerrado o chat secreto por qualquer um dos integrantes, o chat sumisse da tela inicial de todos os integrantes dessa forma sendo necess√°rio que seja iniciado outro sempre novo. 	 n_util 
Um √≥timo mensageiro. Prefiro Telegram a WhatsApp. Me passa mais confian√ßa. S√≥ tenho um problema: parece que as mensagens demoram pra chegar. N√£o sei se √© problema de conex√£o ou alguma configura√ß√£o no app. 	 n_util 
App √≥timo , possu√≠ √≥timos recursos e personaliza√ß√µes , cada vez aprendo mais √© √≥timo a fun√ß√£o assistir o v√≠deo sem ter que ir para o YouTube , Telegram perfect , xup@ " uatis z√°pi" 	 n_util 
Uso o telegrama por ele ter muito mais op√ß√µes, por√©m ele N√ÉO NOTIFICA as mensagens a maioria das vezes, o que perde todo o sentido da exist√™ncia de um app de mensagens instant√¢neas 	 n_util 
Telegram Excellent ! ! ! Excelente App, n√£o d√° para comparar nada com o Telegram, nem esse "tal mais famoso"; s√≥ famaüòùüëé, Telegram Excellent , s√≥ uma sugest√£o, acrescente quantidade infinita na fun√ß√£o Fixar no topo, que atualmente s√£o apenas 5 posi√ß√µes. 	 util 
N√£o aguento mais esse neg√≥cio de ter que esperar a pessoa se conectar pra eu poder mandar mensagem pra ela. Perco carona por causa dessa coisa IN√öTIL. 	 n_util 
Como come√ßar? Primeiro meu celular foi roubado, Eu n√£o consigo entrar no telegram pois meu chip estava no celular, Ent√£o perdi todos os meu grupos? Tem como logar sem o n√∫mero? 	 n_util 
Est√° perdendo qualidade. No Moto G5 N√ÉO NOTIFICA a entrada de novas mensagens, trava ao enviar imagens... T√° perdendo campo pro WhatsApp. N√ÉO NOTIFICA!!! 	 n_util 
O aplicativo √© muito bom, mas estou com problemas para receber notifica√ß√µes desde d que atualizei o sistema do celular para o Oreo, as notifica√ß√µes n√£o chegam a n√£o ser que abra o app. Corrijam isso por favor 	 util 
uso o telegram a 3 anos e ele tem dois problemas ser√≠ssimos o primeiro √© que ele muitas vezes n√£o notifica as mensagens e o outro √© que mostra que estou online quando n√£o estou espero que voc√™s arrumem isso pq realmente √© muito chato :/ 	 n_util 
O app √© muito bom, mas voc√™s poderiam colocar uma aba lateral para mudar o contato para o qual ser√° enviada a mensagem. Ter que ficar voltando na seta superior esquerda demora muito. 	 util 
O App √© bom, n√£o deve nada ao concorrente, por√©m tem algum problema com notifica√ß√µes, n√£o avisa sobre novas mensagens. Fa√ßam os ajustes, por favor! 	 util 
As notifica√ß√µes n√£o aparecem no momento em alguem manda algo e/ou s√≥ chegam quando abrimos o aplicativo. Arquivar conversar seria uma √≥tima op√ß√£o. 	 n_util 
√ìtimo app, a √∫nica coisa ruim √© que nem sempre ele manda notifica√ß√£o de mensagens, √© chato ter que abrir o app pra ver se tem novas mensagens. 	 n_util 
Excelente Aplicativo ! √â a primeira vez que eu uso o Telegram ! O Telegram superou as minhas expectativas ! Quem reclama do Telegram √© sinal de que n√£o sabe usar o celular e atualiz√°-lo ! Com telegrama d√° para encontrar grupos incr√≠veis sobre diversos assuntos ! O Telegram √© din√¢mico e f√°cil de usar‚Ä¶ resenha completa 	 util 
MARAVILHOSO!!! ELE N√ÉO TEM LIMITE DE √ÅUDIO COMO O WATSAP, COM ELE POSSO MANDAR GRAVA√á√ÉO DE MAIS 30 MINUTOS. PARABENSSSSS 	 n_util 
O aplicativo √© √≥timo mais completo que tem aqui porem precisa ser atualizado pois n√£o est√° notificando acredito que logo eles devem corrigem isso 	 util 
Decepcionado com o telegram, duas contas banidas em menos de um m√™s, e olha que s√≥ tenho canais de fotos da fam√≠lia, de m√∫sicas e livros, falando das m√∫sicas e livros separadamente eram mais de 200 mil cada, muito decepcionado 	 n_util 
O aplicativo n√£o ta enviando o SMS para que eu possa ativar o telegram , por favor arrumem isso a√≠ o mais r√°pido poss√≠vel. 	 n_util 
Amo Telegram, uso apenas ele como app de mensagens. Ponto negativo: essa data que fica suspensa e vis√≠vel em todas as mensagens incomoda muito, essa "data suspensa" est√° nas vers√µes mais novas, por isso, fazendo downgrade... 	 util 
Melhor APP de mensagens instant√¢neas do mundo, melhor do que qualquer outro. Grupos com capacidade de at√© 100000 (cem mil ) participantes, e com capacidade para enviar mensagens de m√≠dia de at√© 1.5 Gb. Amei esse aplicativo. √â de gra√ßa. 	 util 
Colocar a op√ß√£o de salvar gifs direto na galeria ou ilimitar a quantidade a ser salva no pr√≥prio App para a utiliza√ß√£o do atalho direto que aparece no teclado. por favor, obrigado. 	 util 
Tem muito potencial, √© o melhor da categoria mensageiro. Por√©m tem falha na notifica√ß√£o, ele s√≥ notifica quando abre o aplicativo. 	 n_util 
√â um aplicativo maravilhoso!! Por√©m, n√£o chega a notifica√ß√£o quando recebemos novas mensagens.... Isso √© o maior problema! Corrigindo esse erro, t√° blzz 	 n_util 
√â show de bola amo por√©m gostaria de saber como fa√ßo p recuperar o q eu ja deletei?ü§î ser√° q tem como recurepar ? 	 util 
O app √© √≥timo , s√≥ que n√£o est√° notificando as mensagens , mesmo depois de atualizar . Eu j√° desinstalei e instalei e continua com o mesmo defeito . Consertem isso pff üôèüèª 	 util 
Muito bom, por√©m n√£o notifica as mensagens, apenas vibra e n√£o fica registrado na √°rea de notifica√ß√µes que tem mensagem. 	 util 
Muito bom... Melhor que wpp. Por√©m tem problema com notifica√ß√µes.. √†s vezes me mandam mensagem mas n√£o sou notificado na hora.. 	 util 
Muito bom, mas quero que resolva uma √∫nica coisa, as vezes n√£o recebo notifica√ß√£o de mensagem, e quando eu entro no app tem v√°rias mensagens 	 util 
Tive que reinstalar o telegram por umas configura√ß√µes aqui, e agora n√£o estou recebendo o SMS com o c√≥digo. Como procedo para voltar a usar o app? 	 util 
Depois que atualizou n√£o funciona no Wear OS. Envia o c√≥digo de autoriza√ß√£o e fica loading eternamente. Decep√ß√£o √© a palavra 	 n_util 
Muito otimo, adoro o armazenamento na nuvem, os stickers e os BOTs. S√≥ nas notifica√ß√µes que deixa a desejar!! Voc√™ s√≥ minimiza ele e j√° n√£o chega notifica√ß√£o de nada! 	 util 
O aplicativo √© √≥timo. Vamos melhorar as notifica√ß√µes, n√£o estou recebendo notifica√ß√µes das mensagens e elas s√≥ caem quando eu entro! Obrigada. 	 util 
N√£o aparece o microfone pra enviar msg de √°udio. Amo o app mas t√° com esse problema no meu 	 util 
√â o melhor app de mensagens, muito superior ao WhatsApp. Mas desde que meu Android atualizou para Oreo, ele n√£o notifica mais o recebimento de novas mensagens. 	 util 
O aplicativo em si √© maravilhoso, mas de uns meses pra c√° raramente tenho recebido notifica√ß√µes quando recebo mensagens. A minha namorada tamb√©m est√° com o mesmo problema e isso tem nos incomodado muito. Infelizmente parece que teremos que mudar de aplicativo. :( 	 util 
PRECISAMOS DE ATUALIZA√á√ÉO N√â TELEGRAM!!!!! A ULTIMA FOI 28 DE AGOSTO 2018! O APP N√ÉO NOTIFICA MAIS ENTRE OUTROS... URGENTE!! 	 util 
RESOLVAM AS NOTIFICA√á√ïES POR FAVOR! O APP N√ÉO EST√Å NOTIFICANDO EM TEMPO REAL!!! ISSO √â MUITO IMPORTANTE. 	 util 
Simplesmente o melhor üòéüòç mais eu gastaria que colocassem a op√ß√£o arquivar conversas üòò Essa √© minha id√©ia tirando isso amo demais. 	 util 
O telegram √© o melhor app de conversas do mundo! N√£o tenho nenhuma reclama√ß√£o sobre ele s√≥ elogios!!!! Ele √© mt melhor q o WhatsApp!!! Instalem o Telegram vcs v√£o amar. Podem confiar em mim. 	 util 
App top, coloca o Whatsapp no chinelo, por√©m no meu j5 pro n√£o chega a notifica√ß√£o de msg, j√° fiz v√°rios procedimentos e n√£o obtive sucesso. 	 util 
S√≥ falta acertar a fun√ß√£o "exce√ß√µes", n√£o est√° salvando depois de sair das configura√ß√µes, ainda que se clique no V para confirmar 	 util 
√â um bom app, s√≥ deixa a desejar na parte das notifica√ß√µes. Dificilmente recebo notifica√ß√£o da conversa, msm deixando tudo ligado. 	 util 
Melhor app de mensagens, seguro, confi√°vel, emoji e stickers diversos, e tem tantas outras fun√ß√µes... Incr√≠vel! 	 util 
S√≥ notifica mensagens quando o aplicativo est√° aberto. Depois da √∫ltima atualiza√ß√£o come√ßou este problema. 	 n_util 
Adoro esse App, por√©m n√£o recebo mais notifica√ß√µes de um m√™s pra c√°... j√° tentei de tudo e as notifica√ß√µes n√£o registram ü§® 	 util 
Que app perfeito so que eu n√£o tenho muitos amigos pra falar nesse app (patrocina nos ai;-;o YouTube n√£o paga) 	 util 
Essa atualiza√ß√£o de agosto acabou tirando a enter face leve que ele tinha.ficou ruim agora ele n√£o para de fica baixando grifes e arquivos sem nexs mesmo seu n√£o quere que abaixe desenvolvedores do telegram na pr√≥xima atualiza√ß√£o de em uma arrumada nisso que eu mudo minha avalia√ß√£o pra 5 estrelas 	 util 
Minha conta est√° limitada sendo que usei muito pouco esse aplicativo h√° bastante tempo atr√°s e n√£o enviei nenhuma mensagem ofensiva ou spam. Voltei a usar agora e n√£o consigo enviar mensagem pra quem n√£o est√° nos meus contatos. Isso √© um diferencial do telegram e n√£o est√£o me permitindo usar. 	 util 
N√£o estou conseguindo enviar fotos, s√≥ est√° acontecendo isso comigo. Quero saber como resolver 	 util 
Muito bom o App, mas com as √∫ltimas atualiza√ß√µes, as mensagens n√£o est√£o sendo alertadas pra quem recebe!!!! 	 util 
Excelente aplicativo, por√©m ele nao tem mostrado as notifica√ßoes, apenas quando entro no app 	 util 
J√° tem alguns meses que o recursos de modo noturno autom√°tico de acordo com a luz do ambiente n√£o funciona, s√≥ ativa o modo escuro quando coloca em 100% 	 util 
N√£o tem apresentado notifica√ß√µes, s√≥ quando eu abro o aplicativo. Ele desconecta constantemente quando est√° em espera. J√° foi melhor. 	 util 
O Telegram tem tantos recursos bacanas que fica at√© dif√≠cil listar, mas destaco a possibilidade de usar em v√°rios aparelhos simultaneamente ou mesmo s√≥ no computador. E os bots, que fazem de tudo. D√° um banho no WhatsApp! 	 util 
Faltou a chamada de v√≠deo e aba de status com status de 1:00. Vai ultrapassar mais ainda o WhatsApp. E as notifica√ß√µes n√£o est√£o chegando na hora certa... 	 util 
Adoro o telegram, mas ficaria melhor se desse para compartilhar artigos, material, documento,√°udios. 	 util 
Era muito bom, pra alguns tinha o problema da notifica√ß√£o pra mim n√£o tinha e agora est√°. A mensagens est√£o chegando atrasadas e √© do app, tive que pausar o uso pra usar outro. Pe√ßo que ajeitem gosto muito do telegram. 	 util 
Poderia ter mais emotions, √© bem legal gostei muito mas ainda tem coisas que precisa melhorar. 3 estrelas se melhorar um pouco mais eu aumento a nota. 	 util 
Adoro telegrama! √önico problema √© que as notifica√ß√µes est√£o demorando muito pra chegar, s√≥ qdo entro no app que vejo as mensagens üòï antes n√£o era assim, depois que troquei de celular come√ßou esse problema, mesmo assim acho ele muito bom!!! 	 util 
Demoram para enviar o SMS de confirma√ß√£o, n√£o permitindo cadastrar o n√∫mero e depois aparece mensagem que teve muitas tentativas. 	 util 
Muito bom mesmo! Na realidade, √© o melhor aplicativo de mensagens que eu j√° usei na vida. √â uma pena que nem todo mundo o conhe√ßa, mas vale muito a pena testar e usar. Bem mais seguro, r√°pido e leve do que o seu rival verdinho e mais popular. Parab√©ns aos devs! 	 util 
Aplicativo lixo. Tem mania de banir o n√∫mero das pessoas atoa. Pessoal eu n√£o recomendo que baixem n√£o pois n√£o presta. 	 util 
Eu poderia passar horas falando do quanto o Telegram √© um aplicativo completo. S√≥ tenho a agradecer! J√° s√£o dois anos apenas usando o Telegram. Fa√ßo tudo por ele: converso, fa√ßo download de filmes, s√©ries, animes, mang√°s, programas. Salvo arquivos na nuvem. √â um aplicativo tudo em um. üòé 	 util 
Aplicativo muito bom, por√©m recentemente n√£o tem mostrado as notifica√ß√µes, apenas quando abro o app... Poderia ser corrigido isso... 	 util 
O aplicativo √© √≥timo por√©m, n√£o est√° notificando a exist√™ncia de mensagens at√© que o usu√°rio o acesse. 	 util 
Por alguma raz√£o n√£o consigo entrar com o meu n√∫mero estava logado faz uma semana e do nada deixou de dar 	 util 
√â um aplicativo quase perfeito. Muito superior ao whatsapp, mais famoso. Por√©m seria melhor se houvesse a op√ß√£o de chamadas de v√≠deo. 	 util 
O Telegram √© o melhor do g√™nero, mas s√≥ tenho recebido notifica√ß√µes de msg com atraso de horas e at√© dias, tenho que ficar abrindo constantemente o app pra ver se tem msg's. 	 util 
Estou usando ele mais agora e estou gostando muito dle, fun√ß√µes um pouco diferente do WhatsApp, mas nada q atrapalhe e vai al√©m, ele √© top q n√£o tem limites de membros. Parab√©ns a quem o inventou.üëèüëèüëèüëè 	 util 
O app era √≥timo, por√©m ap√≥s a √∫ltima atualiza√ß√£o ele parou de notificar, app de msm que n√£o notifica √© p√©ssimo. Por favor consertem isso. Vcs ir√£o perder usu√°rio para o WhatsApp!!! 	 util 
O Telegram fica deslogando (saindo) da minha conta SOZINHO! eu entrei algumas vezes de volta e agora ele simplesmente n√£o me deixa entrar porque eu fiz "muitas tentativas". quero usar o aplicativo, pois dependo dele pra algumas coisas! 	 util 
Minhas mensagens vem com um bot√£o vermelho e n√£o consigo postar. Como desativo esse bot√£o para poder enviar minhas mensagens? 	 util 
Adoro o app mais gostaria de informar que n√£o estou recebendo notifica√ß√µes do app quando recebo msg ap√≥s a √∫ltima atualiza√ß√£o vlw 	 util 
Estou tendo um probleminha, as vezes recebo a mensagem mas n√£o sou notificado. Meu celular √© um Samsung S8. 	 util 
Muito melhor que o concorrente, m√≠dia fica salva na nuvem, grupos com at√© 5.000 membros, um al√≠vio na mem√≥ria do celular... 	 util 
Eu j√° estava deixando o WhatsApp quase que completamente de lado para usar o telegram. Mas, infelizmente, com a √∫ltima atualiza√ß√£o as notifica√ß√µes n√£o est√£o funcionando bem, al√©m de que √†s vezes, quando abro a conversa, o aplicativo fica atualizando e algumas mensagens somem, sendo necess√°rio reabri‚Ä¶ resenha completa 	 util 
√â bom mais se ele notificasse quando recebesse a msg seria melhor ainda.. Poucas pessoas usa ele,mais eu gostei.. s√≥ mudar pra ele n√≥s notificar quando receber uma msg eu aumento as estrelas 	 util 
Olha, telegram da de 10 a 0 no WhatsApp, h√° muitas fun√ß√µes, como tamanho de v√≠deo ilimitado, modo 2x pra escutar √°udio, grava√ß√£o infinita de v√≠deo, mudan√ßa de temas, al√©m de outras fun√ß√µes q para mim, me auxilia em tudo que preciso. Est√£o de parab√©ns!!! 	 util 
Gostei demais do App. Mas na pr√≥xima atualiza√ß√£o, podiam colocar status. Eu n√£o uso WhatsApp, e no telegram s√≥ falta isso: STATUS pra postar fotos a vontadeü§ó 	 util 
Poderia colocar chamada de v√≠deo e status para compartilhamos as coisas e os adesivos poderiam se mover igual o Messenger 	 util 
Eu baixei,mas n√£o me enviaram o c√≥digo,fiquei muito chateada 	 util 
Um excelente aplicativo. Gosto bastante da possibilidade de trocar o idioma apenas dentro do app e o Telegram me da essa possibilidade 	 util 
Nao do 5 pq falta controle adm de canais e senha com suporte a mais caracteres, so 4 e fraco, e voltando, melhorar a nomeacao de adm pra canais, pra nao precisar adc o numero pra colocar de adm, e mt chato isso, nos grupos nao precisa, fora isso mt bom, leve e seguro 1000 a 0 no lixo do wts. Seria b‚Ä¶ resenha completa 	 util 
Caros amigos, o aplicativo √© muito bom, parab√©ns! Voc√™s podiam colocar a op√ß√£o de quem visualizou a sua mensagem no chat do grupo, com isso ficaria mais perfeito do que j√° √©. OBRIGADO 	 util 
Although it is (was) the best messenger app, notifications doesn't work properly. 	 n_util 
J√° tenho o telegram faz um tempo, gosto muito , mas como li em coment√°rios anteriores ele est√° com problemas nas notifica√ß√µes pois nao est√° dando os alertas so vejo que me enviaram mensagens quando abro o aplicativo. Por gentileza podem dar uma verificada e corrigir esse erro. Aplicativo otimo recom‚Ä¶ resenha completa 	 util 
Perdi todas as mensagens que eu tinha salvas no aplicativo. Ap√≥s a √∫ltima atualiza√ß√£o ele s√≥ trava. T√° horr√≠vel. 	 util 
Tem v√°rios bugs, por isso dei apenas 3 estrelas, a liga√ß√£o oscila o sinal o tempo todo, tem horas que ele trava o celular, s√≥ conseguimos abri-lo novamente quando reiniciamos o aparelho, isso quando o app n√£o encerra sozinho, meu celular tem 4 gb de RAM e um snapdragon 845 com adreno de 630 e mesmo ‚Ä¶ resenha completa 	 util 
Preciso ajuda!! J√° estou usando o Telegram com o novo celular e o novo n√∫mero. Entretanto, n√£o consigo instalar o app no notebook. O app aparece como instalado... s√≥ n√£o aceita o dispositivo!! O que fazer?? 	 util 
Gostei muito do aplicativo, mas o ruim dele √© que n√£o notifica quando recebo mensagens, e s√≥ vejo as mensagens quando eu abro o app. Espero que consigam ajeitar logo isso. Bjs. 	 util 
√â bacana, mas t√° dificil de logar... ali√°s, imposs√≠vel de logar, pois tenho o numero j√° cadastrado, por√©m nao consigo conectar, sendo que est√° pedindo digita√ß√£o de c√≥digo que n√£o est√° chegando para mim (sendo que j√° tinha feito essa etapa quando baixei o Telegram). Como disse: Bacana!! Mas t√° difici‚Ä¶ resenha completa 	 util 
Eu n√£o estou conseguindo entrar no telegram, pois N√ÉO foi enviado o cod. em meu celular para a confirma√ß√£o. Algu√©m da assist√™ncia pode me ajudar? 	 util 
Quero de vez usar s√≥ o telegram, mas ELE NAO NOTIFICA AS MENSAGENS, arrumem isso galera, vcs tem tudo para ser o melhor mensageiro online 	 util 
A atualiza√ß√£o estragou ele, n√£o estou conseguindo enviar √°udios, s√≥ aparecia para enviar v√≠deo mas agora nem isso, fora que n√£o notifica as mensagens enviadas direito 	 util 
Deixa o concorrente whats no chinelo. E melhor pra conversar, pra √°udios, pra enviar arquivos, pra grupos (que podem ter at√© 100.000), e n√£o precisa fazer backup quando troca de celular. Simplesmente o melhor. 	 util 
Tem pessoas em outros pa√≠ses usando o meu n√∫mero neste aplicativo, como isso √© poss√≠vel??? Solicito provid√™ncias da plataforma urgente ou entrarei com um processo judicial por danos morais.... 	 util 
Gostaria de pergunta os desenvolvedores do aplicativo por que tem uma op√ß√£o de apagar a conta no telegram mais n√£o paga a conta pois t√¥ tentando apagar a conta e n√£o t√° apagando por que... 	 n_util 
Falha notifica√ß√£o de novas mensagens. A notifica√ß√£o s√≥ chega quando se acessa o app ou no momento do desbloqueio.. 	 util 
Ele √© otimo, d√° pra sincronizar no pc sem ficar caindo o sinal (diferente do whatsapp). Da pra editar mensagens j√° enviadas. Tem os adesivos kkkk. 	 util 
Gostei o problema e q tem hora q diz q a pessoa est√° online mas n√£o ta por favor comcertem isso 	 n_util 
O √∫nico problema √© q o online e o visto por ultimo √© bem bugado, √© todo errado msm 	 n_util 
Eu n√£o sei se √© bom pq tem que ter ele para conversar com as pessoas n√£o d√° para conversar com pessoas que tem whatsapp 	 n_util 
Problema.. √© que as notifica√ß√µes padr√£o √© irritante ...mesmo marcando para usar sons do sistema..ele continua na padr√£o 	 n_util 
Da nao para ligar para oitris pa√≠ses sem pagar 	 n_util 
Poucos recursos em rela√ß√£o a WhatsApp e Telegram 	 util 
Melhor experi√™ncia em comunica√ß√£o Web 	 util 
√ìtimo 	 n_util 
√â pago esse aplicativo? Achei que fosse gratuito como o watsap e telegramüòû Aqui diz ser gratuito e n√£o vi essa op√ß√£o 	 n_util 
O aplicativo mostra que a pessoa est√° online sem ela estar 	 n_util 
E muito para as conversas rapidas 	 n_util 
Muito util 	 util 
Parece ser bom mais n√£o tou sabendo usar s√≥ por isso vou desinstalar mais parab√©ns ao desenvolvedor Deus aben√ßoi 	 n_util 
Bom 	 util 
Fiquei um m√™s suportando as travadas e erros do Skype no meu tablet, enfim resolvi testar o Viber que tem sido excelente! Muito superior! Mais leve, mais r√°pido e mais est√°vel! 	 n_util 
S√≥ tem um problema na rede que eu uso aqui se eu quizer ouvir audios e ver midias tenho que conectar a um VPN. No trabalho 	 n_util 
Bom programa, s√≥ n√£o gosto de n√£o poder mover o s√≠mbolo de liga√ß√£o que fica fixo na tela e impede de escrever email e outros. 	 n_util 
O viber t√° estranho quando envio um √°udio ele fica ruim parece que o fone t√° quebrado mais em outros apps o √°udio sai normal 	 n_util 
N√£o est√° funcionando com fone de ouvido, continua saindo o √°udio pelo aparelho, problema ocorreu depois da atualiza√ß√£o 	 n_util 
Melhor rede de comunica√ß√£o/troca de mensagens, com bonecos/emojis muito bons. Parab√©ns!! 	 n_util 
L'applicazione migliore per parlare con chi vuoi senza spendere un Euro 	 n_util 
Precisa melhorar o som nas chamadas cai muito. Obrigada 	 util 
Servi√ßo eficiente e dentro das minhas expectativas 	 n_util 
A aplica√ß√£o falha muito 	 n_util 
Excelentes funcionalidades e fiabilidade 	 n_util 
Ainda tem muito a melhorar 	 util 
Adoro viber 	 n_util 
Experimentando a√≠nda 	 n_util 
Tem falhas 	 util 
5 estrelas... 	 util 
Fixe 	 n_util 
√ìtimo 	 util 
Coloquei cr√©ditos na minha conta pq precisava usar rapidamente, coloquei pela google store, pq j√° tinha meus dados e os cr√©ditos simplesmente sumiram mas foram descontados no meu cart√£o. Nada legal! 	 n_util 
S√≥ troca propre ko quele √© 3 vez quim SA instala ta tomam s√≥ mega ka ta instala nada nhos dexa de faze roubo PA depois PA nhos bem fla e problemas...... 	 n_util 
Uma frase que descreve muito bem este aplicativo: Simplesmente maravilhoso!üòç Os meus parab√©ns aos criadores. 	 n_util 
Oq aconteceu com o app? Nao da mais pra ver qd os contatos entraram pela ultima vez... nem qd ta escrevendo... do nada isso? 	 n_util 
Liga√ß√µes de √≥tima qualidade, confi√°veis e muito baratas. 	 n_util 
Estava mudando do watzap para o Viber, n√£o funciona byby 	 n_util 
Muito √∫til e pr√°tica. Obrigada 	 n_util 
Gosto e √© muito √∫til. Parab√©ns 	 n_util 
N√£o consigo abrir as mensagens de imagens que recebo 	 n_util 
Fant√°stica Aplica√ß√£o. A Must Have! 	 n_util 
√ìtimo para fazer liga√ß√µes internacionais 	 n_util 
Nao tenho criticas, gosto mtlo . 	 util 
N√£o tenho a observar 	 util 
Great app 	 n_util 
Muito bom 	 util 
Muito fixe 	 util 
Maravilhoso 	 util 
Daora 	 util 
Boa 	 util 
Por vezes demoro a receber as mensagens. A √∫ltima vez foram quase 2 dias. 	 n_util 
O Viber √© o melhor App de mensagens...MUITO melhor que whatsapp....Eu amo! 	 n_util 
Gosto bastante desta aplica√ß√£o. Muito r√°pida e de f√°cil utiliza√ß√£o. 	 n_util 
Continuem a melhorar o som que nem sempre √© bom. Obrigada 	 util 
√ìtimo recurso para acessar os amigos e futuros amigos e at√© os n√£o amigos ainda 	 util 
Uso pouco mas n√£o tenho tido problemas 	 util 
Melhor aplicativo de comunica√ß√£o. Integra√ß√£o com PC √© um dos melhores atributos. 	 util 
Jeg er forn√∏yd med appen. 	 util 
De vez enquando cai a liga√ß√£o 	 util 
Excelente aplica√ß√£o. N√£o √© intrusiva como o Skype. 	 util 
N√£o tenho do que reclamar √© muito bom! 	 util 
Aplicativo confi√°vel e eficiente para comunica√ß√£o! 	 util 
√â um aplicativo que eu recomendo! 	 util 
Para mim ta td bm. 	 util 
√â tudo d bommm! 	 util 
Muito bom. Figurinhas engra√ßadas. 	 util 
Precisa demais seguran√ßa 	 util 
Muito bom mesmo. 	 util 
Muito bom! 	 util 
Muito Boa aplica√ß√£o 	 util 
√ìtimo! 	 util 
omooooo! 	 util 
Muito boa.üòâ 	 util 
App Fant√°stico 	 util 
Excelente! 	 util 
Excelente! 	 util 
Processamento e lento 	 util 
Gosto bastante 	 util 
Muito bom 	 util 
Very good 	 util 
Gosto assim 	 util 
Bomüòâ 	 util 
Funcional. 	 util 
Legal 	 util 
Excelente 	 util 
Boa 	 util 
Excellent 	 util 
Good 	 util 
Perfeito 	 util 
√ìptimo 	 util 
N√£o consigo digitar o c√≥digo QR e n√£o ha maneira de o digitar . Se me conseguirem dar alguma sugest√£o agrade√ßo,e melhoro avalia√ß√£o. 	 n_util 
Gostei, n√£o tive nenhum tipo de problema pra instalar e nem pra utilizar. 	 n_util 
Muito bom!! Super recomendo!! Ja faz um tempo que uso e n√£o tive nenhum problema. ‚ù§üòç 	 util 
S√≥ tenho problemas com o envio e o recebimentos de imagens, pq n√£o carrega, s√≥ no PC, mas o App √© MT bom 	 util 
Quando apaga tela vc n√£o recebe as mensagens 	 n_util 
Eu n√£o recebo mensagens na tela do meu celular , 	 util 
Todos os adesivos deviam ser de gra√ßa poxa 	 util 
App muito bom. 	 util 
Muito bom 	 util 
Excelente 	 n_util 
Bom bom bom 	 util 
Bom 	 util 
Ok 	 util 
Excelente 	 util 
A aplica√ß√£o √© boa no geral. Pena que mostra os utilizadores online quando eles n√£o est√£o e cria conflito entre os casais. Da para resolverem isso?? 	 n_util 
N√£o est√° funcionando bem no zenfone zoom S. N√£o recebe notifica√ß√µes de novas mensagens. S√≥ se sabe que tem mensagens novas se abrir o app. 	 n_util 
Na tablete troca os nomes da lista. Todos os que tenham viber.?,os restantes + ou - normal. 	 n_util 
Excelente a chamada por v√≠deo. N√£o trava e d√° uma √≥tima vis√£o. Top 	 n_util 
O multi-bilion√°rio japon√™s (Mikitani da Rakuten) que o comprou, com certeza vai deixar o VIBER cada vez melhor! 	 util 
√ìtimo em envio de mensagens e bonito. R√°pido desempenho e receptividade de mensagens sem cobertura de an√∫ncios. 	 util 
Amoo,melhor que o whats app,sem d√∫vidas! 	 n_util 
Boa aplica√ß√£o com f√°cil desempenho e boa transmiss√£o. 	 util 
Esse app aproximou pessoas que amo muito. 	 util 
At√© agora, tudo bem! 	 util 
Mais ou menos! 	 util 
Aplicativo excelente! 	 util 
√ìtimo app!!üëç 	 util 
P√©ssimo para chamadas de voz 	 util 
Voc√™s s√£o os maiores 	 util 
Ta muito lento 	 util 
Muito bom üôèüèΩ 	 util 
O melhor. 	 util 
üòòüòòüòòüòòüòò 	 util 
Sound is wick 	 util 
Muito sociav√©l 	 util 
eu adorei 	 util 
Bom e top top 	 util 
Obrigado 	 util 
Boa 	 util 
Depois 	 util 
Excelente...s√≥ as chamadas de v√≠deo/√°udio ficam melhores pelo Duo 	 n_util 
Muito bom √© 10 	 n_util 
Melhor app 	 n_util 
O meu irm√£o tava mechendo no meu celular e tirou a vers√£o beta, agora s√≥ aparece que atingiu o limite. Outro problema √© que ele fica parando direto, por favor. Consertem isso, por favor! 	 n_util 
As notifica√ß√µes do App n√£o est√£o funcionando. Sem som. N√£o √© problema do meu aparelho! Pe√ßo que resolvam. 	 n_util 
O melhor! 	 n_util 
Sem palavras 	 n_util 
Parab√©ns 	 util 
Adoro 	 n_util 
BOM 	 util 
N√£o est√° dando pra atualizar a foto de perfil e nem o recado, ocorre um erro e manda tentar novamente depois mas nunca vai, arrumem isso por favor 	 n_util 
Atualizei o celular e o app n√£o inicia o download. E olha que a internet √© boa. J√° tem pelo menos uma hora de download pendente. 	 n_util 
Eu queria te WhatsApp atualizasse e desce na parte de status do WhatsApp desce para criar grupo no status no WhatsApp grupo para mandar v√≠deo de m√∫sica eso Eira 	 n_util 
Toda vez que vou apagar conversas,o wpp trava e nao chega mais mensagens. . 	 n_util 
Deveria ter um jeito pra quando vc sai de um grupo, e n√£o conseguem adicionar de novo 	 n_util 
Lixo apareceu mais de 200 contatos de pessoas que nem conhe√ßo e do nada n√£o instalem 	 n_util 
Cuidem em disp√¥r as fun√ß√µes beta pra meu moz√£o , deixem de fulerage 	 n_util 
Pelo amor de deus criem op√ß√£o bloquear liga√ß√£o 	 n_util 
O som da notifica√ß√£o nao quer pegar por isso 	 n_util 
Muito bom recomendoüòä 	 n_util 
Tem problemas com muita frequ√™ncia üòíüòí 	 n_util 
Muito bom, nota 2 	 n_util 
Excelente aplicativo. 	 n_util 
√ìtimo app. 	 n_util 
Chamado em grupo 	 n_util 
Amei 	 n_util 
Bom 	 n_util 
Bom 	 n_util 
Maravilhoso 	 n_util 
Perfeito 	 n_util 
Top 	 n_util 
Otimo 	 n_util 
Oii 	 n_util 
Meu Whatsapp Esta banido, eu n√£o fiz nada fora o termo de uso, eu preciso da minha conta para trabalhar Normalmente, mais nao est√° Dando certo. Nao gostei de nada disso. Ja passou de 72 horas e nao foi liberado. 	 n_util 
Depois q ocorre um flood de stickers no grupo o aplicativo pede para restaurar as mensagens, j√° √© a segunda vez que isso ocorre, hj perdi 8 horas de conversas 	 n_util 
Poderiao fazer uma atualiza√ßao com almento dos videos do stattus, 30 segundos e pouco..1 minuto taria bomüëèüòé 	 n_util 
ol√°, estou tendo um problema com meu whatsapp, ele est√° se reiniciando sozinho ;-; fa√ßam o favor de resolver isso, obrigada. 	 n_util 
N√£o consigo ver os status de ningu√©m. Fica dizendo que:o Whatsapp parou.. Affff Concertem isso 	 n_util 
Desde que a atualiza√ß√£o foi baixada ele n√£o abre. Fecha instantaneamente. Um saco mesmo. P√©ssimo funcionamento üò† 	 n_util 
O app e bom mais minha namorada n√£o respondeüò≠ 	 n_util 
Nem bom, nem ruim, na medida certa. 	 n_util 
reinstalei mas t√° sem som de notificacao 	 n_util 
Gostei desta nova atualiza√ß√£o. 	 n_util 
N√£o avisa as notifica√ß√£o de msm pesimo 	 n_util 
Tinha que tirar an√∫ncios enganados 	 n_util 
Amo whatsapp. 	 util 
N√£o ta entrando 	 n_util 
E um aplicativo maravilhoso 	 n_util 
Muito bom ‚ù§ 	 n_util 
Muito bom 	 n_util 
Ameiiiiii 	 n_util 
Bom 	 n_util 
Muito bom 	 util 
√ìtimo 	 n_util 
Blz 	 n_util 
Bom 	 n_util 
Beleza, meu WhatsApp tava normal at√© um tempo atr√°s e de l√° pra c√° apareceu um problema em que n√£o consigo enviar e nem receber mensagens. S√≥ quero que voc√™s arrumem isso, por favor ! 	 n_util 
Gosto muito, mas a √∫ltima atualiza√ß√£o desabilitou o meu flash frontal ,üíî 	 n_util 
Por que esta dando tanta propaganda? Esta horrivel, odiamos 	 n_util 
Hoje em dia se tornou um app necess√°rio 	 n_util 
Esse app √© muito top 	 n_util 
poderiam mudar a cor do app 	 n_util 
Me ajuda a atualizar 	 n_util 
Muito bom 	 n_util 
Bom 	 n_util 
Bug 	 n_util 
Antes de atualizar, na C√¢mara do wpp eu conseguia tirar foto com o flash frontal do J7 prime, depois de atualizar quando vou tirar a foto, n√£o liga o flash, apenas a tela fica branca e bate a foto 	 n_util 
O app √© muito bom, agora todo santo dia atualiza isso enche o saco! Poderia ser Dantas diferentes. 	 n_util 
Ta na hora de mudar a cor dele e por para a gente escolher a cor de cada coisa!!! 	 n_util 
N√£o consigo enviar nem receber mensagens, arrumem isso por favor! 	 n_util 
Legal mas dae muito erro 	 n_util 
N√£o recebo notifica√ß√µes de novas mensagens. 	 n_util 
Pica thu fly 	 n_util 
Muito bom msm 	 n_util 
Pode melhorar 	 n_util 
Melhor do mundo 	 n_util 
Mais usado 	 n_util 
Eu ameiüíï 	 n_util 
Excelente 	 n_util 
Satisfat√≥rio 	 n_util 
√ìtimo 	 n_util 
T√° travando n√£o recebo mas menssagens nem consigo mandar mas t√° horr√≠vel n√£o consigo ver mas meu aplicativo foram que se atualizar vai bloquear e a√≠ que fa√ßo.... 	 n_util 
Depois da nova atualiza√ß√£o do software, tiraram o falsh externo da c√¢mera e colocaram um interno. Por favor TRAGAM DE VOLTA O EXTERNOOOOO 	 n_util 
MEU FLASH SUMIU DA C√ÇMERA E TA UM NEG√ìCIO HORR√çVEL , RESOLVAAAA ISSOOOO SENHOR MARK ü§¨ü§¨ü§¨ 	 n_util 
O meu n√£o mudou em nada com a atualiza√ß√£o continua a msm coisa e n√£o tenho as figurinhas no meu teclado üòê 	 n_util 
Meu aplicativo de WhatsApp n√£o est√° acendendo o flash na c√¢mera frontal. 	 n_util 
Muito bom eu amo ‚ù§Ô∏èmais deveria ter mais op√ß√µes! 	 n_util 
Esse aplicativo e muito top!!! 	 n_util 
Muito bom me ajuda muito 	 n_util 
Ele muito bom 	 util 
Amiiii Kkkkkkkkk 	 util 
Est√° travando demais quando quero postar algo no meu status e acaba sumido e n√£o salvando seja ela foto ou v√≠deo. E o flash frotal n√£o est√° funcionando. Isso est√° sendo um caos para n√≥s que utilizamos um app que era de alta qualidade. O que est√° acontecendo com esse app? Est√° caindo demais 	 n_util 
Essa atualiza√ß√£o ficou um lixo. Nao aparece o numero de msg q chega no meu zap. Odiei. Mais respeito pelo usuario por favor. N√£o sei pra q tanta atualiza√ß√£o. So pra ficar pior do q u q eraüò° 	 n_util 
Olha gostei do app, so que vcs tem que atualizar de novo pq o meu ta aparecendo emojis que nenhum dos meus amigos tem !!! 	 n_util 
Ap√≥s a √∫ltima atualiza√ß√£o n√£o consigo tirar fotos com o flash frontal de meu celular, existe algum jeito de reverter isso? As fotos saem horr√≠veis com esse "novo" flash. 	 util 
O aplicativo √© muito bom, mas t√° travando MUITO. As vezes n√£o da pra mandar mensagens 	 n_util 
Esse app √© muito bom mais ele para de funcionar e fica sem funcionar por 2 ou 3 dias 	 n_util 
Eu o amo, mas toda hora uma desgra√ßa de atualiza√ß√£o n√£o tenho memoria n 	 n_util 
So acho q os emojis tem que ser igual de iphone 	 n_util 
N√£o est√° aparecendo o status de contagem das mensagens depois da atualiza√ß√£o! 	 n_util 
Podia ter suporte √† stickers animados. 	 n_util 
Poderia ter mais outra atualiza√ß√µes melhor.....? 	 n_util 
n√£o to conseguindo confirmar meu n√∫mero 	 n_util 
Muito bom parab√©ns pelo app.üëèüëè 	 util 
Meu nn esta atualizando 	 n_util 
Gosto desse App 	 n_util 
Ultimamente est√° travando mt 	 n_util 
E muito legal manow 	 util 
Poderia voltar com os emojis do ios 	 n_util 
Maneiro esse watsappkkkkkk 	 n_util 
MTV muito bom 	 n_util 
Amei! 	 util 
Muito bom 	 n_util 
Amo 	 n_util 
Top 	 n_util 
Bom 	 n_util 
Bom 	 n_util 
Top 	 n_util 
Ruim 	 n_util 
Incr√≠vel 	 util 
Otimo 	 util 
eu dei cinco estrelas s√≥ porque veio novidades q foi as figurinhas mas tem um por√©m mais para as pessoas que tem defici√™ncia visual ainda se precisa melhorar bastante porque quem usa o talc bec com a voz do Google ainda tem muita dificuldades principalmente nas figurinhas do zapp 	 util 
Est√° horr√≠vel. Quando vou postar status, sempre d√° erro. O aplicativo fecha. üôÑ 	 n_util 
Fazem 2 horas que atualizei e ja esta pedindo atualiza√ß√£o novamente..... socorro n√© 	 n_util 
Eu amo muito bom 	 n_util 
Gostei mais n√£o gostei 	 n_util 
Sem muito o que comentar.. apenas gostei das facilidades 	 util 
Muito bom 	 n_util 
Est√° bem 	 n_util 
E muito bom 	 util 
Muito bom 	 n_util 
D boas 	 n_util 
Otimo 	 n_util 
Bom 	 n_util 
Gosto muito do WhatsApp por√©m ele deixa muito a desejar em termo de personaliza√ß√£o . Sempre √†s mesma cor poderia tem como n√≥s personalizar do nosso jeito e tamb√©m poderia ter como desligar o wi-fi nele sem precisar desligar a internet geral. 	 n_util 
Muito Bom. S√≥ uma pergunta queria saber de vcs que criar√£o o whatsapp qualquer eo verdadeiro significado dos emojis lua do whatsapp üåûüåùüåö √© verdade oq dizem ????? Favor aguardo a resposta 	 n_util 
O aplicativo est√° apresentando m√° funcionamento em meu celular. N√£o consigo baixar √°udios ou adesivos, d√° como arquivo n√£o suportado. Por favor, resolvam esse problema. Grata. 	 n_util 
O flash da c√¢mera frontal n√£o liga..j√° tentei fazer de tudo mais n√£o liga. 	 util 
Hoje o whatsapp est√° imposs√≠vel se ser usado, pense num bug, t√¥ pretendendo parar de usar. 	 util 
T√° na hora de p√¥r o beta pra ficar dispon√≠vel pra todo mundo. 	 n_util 
Os filtros de fotos para status n√£o est√° aparecendo. 	 n_util 
N√£o querem me mandar o c√≥digo de confirma√ß√£o do meu n√∫mero 	 n_util 
Muito bom , s√≥ devia melhorar nas chamadas de v√≠deo e na de telefone 	 n_util 
Mudei de n√∫mero e fui transportar minha conta do Whatsapp, eles simplesmente n me mandam o c√≥digo de verifica√ß√£o.. Nem por mensagem nem por liga√ßao .. J√° tentei de tudo j√° segui todas as instru√ß√µes, li o FAC de verifica√ß√£o e n√£o achei a solu√ß√£o, entrei em contato com o suporte e me respondem com a m‚Ä¶ resenha completa 	 util 
Excelente app de comunica√ß√£o social fant√°stico. 	 n_util 
Muito bom, recomendo o APP para TDs... 	 n_util 
S√≥ queria as figurinhas novas 	 n_util 
√Äs vezes fica travando mais 	 n_util 
Esse aplicativo √© otimo 	 n_util 
Tudo de bom 	 n_util 
mais ou menos 	 util 
MT bom... 	 n_util 
√â √≥timo 	 n_util 
*EXCELENTE* 	 n_util 
Legal 	 n_util 
Bom 	 n_util 
√ìtimo 	 n_util 
Adorooo 	 n_util 
Ameiiiiiii 	 n_util 
Bom 	 n_util 
Legalzinho 	 n_util 
Depois da √∫ltima atualiza√ß√£o n√£o estou conseguindo enviar algumas m√∫sicas...isso √© muito chato ..v√£o tds os videos e fotos mas apenas algumas m√∫sicas v√£o...por favor quero saber oq est√° acontecendo antes era super d boa agora t√° com isso ... 	 n_util 
o apk √© muito bom, mas esta apagando as minhas conversas sem ningu√©m mexer. Trabalho com vendas, preciso das minhas conversas salvas e n√£o duram nem 2 dias no celular. Poderiam arrumar, por favor? 	 n_util 
E uma vergonha em plena √©poca em que os arquivos est√£o cada vez maiores. Eu n√£o posso enviar um video grande para um amigo. O video vai pela metade. Isso √© uma piada! 	 n_util 
Adorei os novos emojis, por√©m poderia mudar essa arma horr√≠vel de √°gua para uma pistola normal. Seria bem mais utilizada. 	 n_util 
Decepcionada. Depois da √∫ltima atualiza√ß√£o, VC posta uma foto no status ai a qualidade da foto muda totalmenteüò¢ 	 n_util 
√ìtimo, pena que quando est√° no videoconfer√™ncia n√£o tem a op√ß√£o de ativar a lanterna que fica ao lado da c√¢mera de selfie 	 n_util 
√â bom s√≥ que n√£o est√° mais enviando o SMS para mim por favor me envie 	 util 
Mesmo o visto por √∫ltimo desativado as outras pessoas conseguem ver , corrija isso 	 n_util 
Eu tenho um Moto G6 Play, e n√£o tenho os novos emojis, sendo que no meu dispositivo anterior, Samsung A5, eu tinha, sendo que era um dispositivo inferior 	 util 
O melhor app de comunica√ß√£o e mensagensüëèüëè 	 n_util 
O whatsapp eh mt bom 	 n_util 
Eu adorei esse app 	 n_util 
V√°rios contatinhosüòù‚ù§Ô∏è 	 util 
A cada atualiza√ß√£o t√° ficando pior!.üò† 	 util 
Eu Super recomendo 	 n_util 
Muito bom 	 n_util 
